"character_trait_levels_colour_text_wh2_main_trait_def_name_of_power_ar_01_lifequencher"	""	"True"
"character_trait_levels_explanation_text_wh2_main_trait_defeated_belegar_ironhammer"	"Defeated Belegar Ironhammer"	"True"
"character_trait_levels_explanation_text_wh2_dlc09_trait_defeated_khalida"	"Defeated High Queen Khalida"	"True"
"character_trait_levels_explanation_text_wh2_main_trait_wins_against_skaven"	"Achieved victory over Skaven multiple times"	"True"
"character_trait_levels_removal_text_wh2_main_trait_def_name_of_power_ar_06_fangshield"	""	"True"
"character_trait_levels_explanation_text_wh_dlc04_trait_name_dummy_ghorst"	""	"True"
"character_trait_levels_removal_text_wh_dlc03_trait_name_dummy_todbringer"	""	"True"
"character_trait_levels_colour_text_wh2_dlc09_dummy_trait_dynasty_6"	"This warrior-king was unmatched in chariot tactics. Only the finest crews served under him - and will again, of courseâ€¦"	"True"
"character_trait_levels_colour_text_wh2_dlc09_dummy_trait_dynasty_5"	"Ruling in the wake of the war with Nagash, Setep restored the Necropolis and the Priesthood to their former glory."	"True"
"character_trait_levels_colour_text_wh2_dlc09_dummy_trait_dynasty_4"	"Lahmizzash continued the fight against Nagash, retaking sacred Khemri with the aid of his potent Ushabti."	"True"
"character_trait_levels_colour_text_wh2_dlc09_dummy_trait_dynasty_3"	"The son of Khetep ruled only briefly before his death, but his grasp of engineering and urban development were legendary."	"True"
"character_trait_levels_colour_text_wh2_dlc09_dummy_trait_dynasty_2"	"Conquering lands beyond the mountains east of Nehekhara, Rakhash was a bringer of great prosperity."	"True"
"character_trait_levels_colour_text_wh2_dlc09_dummy_trait_dynasty_1"	"Wakhaf repelled the nomads and secured the borders. He is a peerless master of desert warfare."	"True"
"character_trait_levels_onscreen_name_wh2_main_trait_defeated_lord_mazdamundi"	"Spawnkiller"	"True"
"character_trait_levels_colour_text_wh2_main_trait_def_name_of_power_ar_08_moonshadow"	""	"True"
"character_trait_levels_onscreen_name_wh2_main_trait_defeats_against_beastmen"	"Fears Beastmen"	"True"
"character_trait_levels_colour_text_wh2_main_trait_def_name_of_power_ca_11_gatesmiter"	""	"True"
"character_trait_levels_onscreen_name_wh2_main_trait_defeated_morathi"	"Hagbutcher"	"True"
"character_trait_levels_explanation_text_wh2_main_trait_reinforcing_vampires"	"Reinforced Vampire Counts armies in battle multiple times"	"True"
"character_trait_levels_removal_text_wh2_main_trait_wins_against_chaos"	""	"True"
"character_trait_levels_onscreen_name_wh_dlc03_trait_name_dummy_todbringer"	""	"True"
"character_trait_levels_colour_text_wh2_main_trait_ruler_personality_morathi_dark_manipulator"	""I would be so grateful for your cooperation in this, my lord. I do so hate to be... disappointed.""	"True"
"character_trait_levels_removal_text_wh2_main_trait_defeated_teclis"	""	"True"
"character_trait_levels_colour_text_wh_dlc07_trait_brt_lord_bad_perverted_1"	"You have Slaanesh's wandering eye, my lord."	"True"
"character_trait_levels_removal_text_wh2_main_trait_skv_boom_master"	""	"True"
"character_trait_levels_explanation_text_wh_dlc04_trait_name_dummy_the_grim"	""	"True"
"character_trait_levels_colour_text_wh2_dlc09_trait_settra_title_3"	""Kneel before the might of Settra the Imperishable, Khemrikhara, Lord of the Earth, He Who Holds The Sceptre, High King of Nehekhara, Ruler of the Four Horizons, Monarch of the Sky, Mighty Lion of the Infinite Desert, The King of Kings, Great Hawk of the Heavens, Majestic Emperor of the Shifting Sands and Eternal Sovereign of Khemri's Legions.""	"True"
"character_trait_levels_colour_text_wh2_dlc09_trait_settra_title_2"	""Kneel before the might of Settra the Imperishable, Khemrikhara, Lord of the Earth, He Who Holds The Sceptre, High King of Nehekhara, Ruler of the Four Horizons, Monarch of the Sky, Mighty Lion of the Infinite Desert...""	"True"
"character_trait_levels_colour_text_wh2_dlc09_trait_settra_title_1"	""Kneel before the might of Settra the Imperishable, Khemrikhara, Lord of the Earth, He Who Holds The Sceptre...""	"True"
"character_trait_levels_removal_text_wh2_main_trait_defeated_kholek_suneater"	""	"True"
"character_trait_levels_explanation_text_wh2_main_trait_def_favoured"	"Awarded through a Loyalty dilemma."	"True"
"character_trait_levels_explanation_text_wh2_main_trait_general_status_all_cursed"	""	"True"
"character_trait_levels_onscreen_name_wh_dlc07_trait_brt_lord_good_defeated_archaon_1"	"Doomslayer"	"True"
"character_trait_levels_onscreen_name_wh_dlc07_trait_brt_lord_bad_raider_1"	"Raider"	"True"
"character_trait_levels_colour_text_wh_dlc07_trait_brt_lord_good_industry_1"	"The workshop floor is far more important to the survival of the realm than the field."	"True"
"character_trait_levels_removal_text_wh_dlc07_trait_brt_lord_good_defeated_manfred_1"	""	"True"
"character_trait_levels_removal_text_wh_main_trait_name_dummy_de_bordeleaux"	""	"True"
"character_trait_levels_colour_text_wh2_main_trait_reinforcing_humans"	"Only by uniting the nations can mankind hope to thrive."	"True"
"character_trait_levels_removal_text_wh_main_trait_name_dummy_the_ever-watcher"	""	"True"
"character_trait_levels_removal_text_wh2_main_trait_defeats_against_vampires"	""	"True"
"character_trait_levels_removal_text_wh_dlc07_trait_brt_lord_bad_raider_1"	""	"True"
"character_trait_levels_removal_text_wh_dlc07_trait_brt_lord_good_victory_1"	""	"True"
"character_trait_levels_removal_text_wh_dlc07_trait_brt_lord_good_victory_2"	""	"True"
"character_trait_levels_removal_text_wh_dlc07_trait_brt_lord_good_victory_3"	""	"True"
"character_trait_levels_onscreen_name_wh_dlc07_trait_brt_lord_bad_attacker_2"	"Poor Attacker"	"True"
"character_trait_levels_onscreen_name_wh_dlc07_trait_brt_lord_bad_attacker_3"	"Incompetent Attacker"	"True"
"character_trait_levels_onscreen_name_wh_dlc07_trait_brt_lord_bad_attacker_1"	"Indecisive Attacker"	"True"
"character_trait_levels_onscreen_name_wh_dlc07_trait_brt_lord_bad_abducter_1"	"Abducter"	"True"
"character_trait_levels_onscreen_name_wh2_main_trait_wins_1"	"Well Known"	"True"
"character_trait_levels_onscreen_name_wh2_main_trait_wins_2"	"Fabled"	"True"
"character_trait_levels_onscreen_name_wh2_main_trait_wins_3"	"Legend"	"True"
"character_trait_levels_onscreen_name_wh2_main_trait_sea_legs"	"Sea Legs"	"True"
"character_trait_levels_explanation_text_wh2_dlc09_trait_spymaster"	"Gained from quest"	"True"
"character_trait_levels_explanation_text_wh2_main_trait_reinforcing_greenskins"	"Reinforced Greenskin armies in battle multiple times"	"True"
"character_trait_levels_explanation_text_wh2_main_trait_wins_against_lizardmen"	"Achieved victory over Lizardmen multiple times"	"True"
"character_trait_levels_removal_text_wh2_main_trait_def_name_of_power_co_03_poisonblade"	""	"True"
"character_trait_levels_onscreen_name_wh2_dlc09_trait_settra_title_start"	"The Imperishable"	"True"
"character_trait_levels_explanation_text_wh_main_trait_name_dummy_gelt"	""	"True"
"character_trait_levels_colour_text_wh2_main_trait_non_corrupted"	"Having succumbed to corruption, this one must somehow overcome their affliction."	"True"
"character_trait_levels_removal_text_wh2_main_trait_def_name_of_power_ca_06_emeraldeye"	""	"True"
"character_trait_levels_removal_text_wh2_main_trait_def_name_of_power_ar_05_beastbinder"	""	"True"
"character_trait_levels_colour_text_wh2_main_trait_defeated_queen_headtaker"	"See how he runs - all the way to the sewer from which he first skulked!"	"True"
"character_trait_levels_explanation_text_wh2_main_trait_defeats_against_skaven"	"Defeated by Skaven"	"True"
"character_trait_levels_onscreen_name_wh2_main_trait_ruler_personality_queek_hates_dwarfs_greenskins"	"Hates Dwarfs & Greenskins"	"True"
"character_trait_levels_onscreen_name_wh2_main_trait_reinforcing_high_elves"	"Likes High Elves"	"True"
"character_trait_levels_colour_text_wh_main_trait_name_dummy_suneater"	"."	"True"
"character_trait_levels_colour_text_wh_main_trait_name_dummy_ironhide"	"."	"True"
"character_trait_levels_explanation_text_wh2_main_trait_defending_victory_2"	"Achieved victory in multiple defensive battles"	"True"
"character_trait_levels_explanation_text_wh2_main_trait_defending_victory_3"	"Achieved victory in multiple defensive battles"	"True"
"character_trait_levels_explanation_text_wh2_main_trait_defending_victory_1"	"Achieved victory in multiple defensive battles"	"True"
"character_trait_levels_colour_text_wh2_main_trait_def_name_of_power_ca_07_barbedlash"	""	"True"
"character_trait_levels_removal_text_wh2_main_trait_agent_action_assault_units"	""	"True"
"character_trait_levels_onscreen_name_wh2_main_trait_siege_defeat_2"	"Confounded by Siegecraft"	"True"
"character_trait_levels_onscreen_name_wh2_main_trait_siege_defeat_3"	"Terrified of Walls"	"True"
"character_trait_levels_onscreen_name_wh2_main_trait_siege_defeat_1"	"Incompetent Besieger"	"True"
"character_trait_levels_colour_text_wh2_main_trait_agent_actions_against_wood_elves"	""They're disinterested, have overly-long limbs and perfect hair. Add those pointy ears to the mix\? Eugh!""	"True"
"character_trait_levels_removal_text_wh2_main_trait_def_name_of_power_co_04_headreaper"	""	"True"
"character_trait_levels_onscreen_name_wh_dlc07_trait_brt_lord_good_far_from_capital_1"	"Crusader"	"True"
"character_trait_levels_colour_text_wh2_main_trait_routed_3"	"There are many horrors stalking the Old World, and this one is afraid of all of them."	"True"
"character_trait_levels_colour_text_wh2_main_trait_routed_2"	"The rumours say this one's breeches are spoiled as soon as the war horns sound."	"True"
"character_trait_levels_colour_text_wh2_main_trait_routed_1"	"This one has the staunchness of a Goblin."	"True"
"character_trait_levels_colour_text_wh2_main_trait_reinforcing_dwarfs"	"The Dawi are a staunch ally."	"True"
"character_trait_levels_onscreen_name_wh2_main_trait_defeated_isabella_von_carstein"	"Cruelty Restrained"	"True"
"character_trait_levels_colour_text_wh2_main_trait_agent_actions_against_chaos"	"The Chaos Gods and their unholy servants will pay!"	"True"
"character_trait_levels_explanation_text_wh2_main_trait_agent_actions_against_skaven"	"Carried out successful [[img:icon_hero]][[/img]]Hero actions against Skaven"	"True"
"character_trait_levels_explanation_text_wh_dlc07_trait_brt_lord_good_reinforcing_1"	"Gained by reinforcing a friendly army"	"True"
"character_trait_levels_colour_text_wh2_dlc09_trait_defeated_arkhan"	"The Liche King may have dark sorcery and the power of the Great Necromancer, but that's not always enough when facing massed-ranks and hefty blades."	"True"
"character_trait_levels_removal_text_wh2_main_trait_wounded"	""	"True"
"character_trait_levels_removal_text_wh2_main_trait_defeated_tyrion"	""	"True"
"character_trait_levels_onscreen_name_wh_dlc07_trait_brt_lord_good_defeated_grimgor_1"	"Hidestriker"	"True"
"character_trait_levels_colour_text_wh_dlc07_trait_brt_lord_good_vampires_1"	"No servant of the Midnight Aristocracy dares stand against the veteran Slayer."	"True"
"character_trait_levels_removal_text_wh2_main_trait_defeated_morghur_the_shadowgave"	""	"True"
"character_trait_levels_removal_text_wh2_main_trait_skv_flayed_tail"	""	"True"
"character_trait_levels_removal_text_wh_dlc06_trait_name_dummy_ironhammer"	""	"True"
"character_trait_levels_onscreen_name_wh2_main_trait_agent_actions_against_greenskins"	"Hates Greenskins"	"True"
"character_trait_levels_explanation_text_wh2_main_trait_defeated_lord_strolk"	"Defeated Lord Skrolk"	"True"
"character_trait_levels_onscreen_name_wh_dlc06_trait_name_dummy_ironhammer"	""	"True"
"character_trait_levels_colour_text_wh2_dlc09_trait_defeated_settra"	"As it turns out, the Imperishable is just as perishable as the rest of usâ€¦"	"True"
"character_trait_levels_explanation_text_wh2_main_trait_stance_raiding"	"Spent multiple turns in Raiding stance"	"True"
"character_trait_levels_removal_text_wh2_main_trait_def_name_of_power_ca_11_gatesmiter"	""	"True"
"character_trait_levels_removal_text_wh2_main_trait_def_name_of_power_ar_08_moonshadow"	""	"True"
"character_trait_levels_removal_text_wh2_main_trait_brutally_honest"	""	"True"
"character_trait_levels_removal_text_wh_dlc07_trait_brt_lord_good_far_from_capital_1"	""	"True"
"character_trait_levels_onscreen_name_wh_dlc07_trait_brt_lord_good_chaos_1"	"Ruin's End"	"True"
"character_trait_levels_removal_text_wh2_main_trait_defeated_balthasar_gelt"	""	"True"
"character_trait_levels_onscreen_name_wh2_main_trait_ruler_personality_tyrion_no_politician"	"No Politician"	"True"
"character_trait_levels_colour_text_wh2_main_trait_wins_against_chaos"	"Dark, corrupting, evil forces have no place here!"	"True"
"character_trait_levels_colour_text_wh2_main_trait_def_name_of_power_ar_06_fangshield"	""	"True"
"character_trait_levels_explanation_text_wh2_main_trait_def_name_of_power_co_09_the_hand_of_wrath"	""	"True"
"character_trait_levels_colour_text_wh_dlc07_trait_brt_lord_bad_coward_1"	"The rumours say this one's breeches are spoiled as soon as the war horns sound."	"True"
"character_trait_levels_removal_text_wh_dlc07_trait_brt_lord_good_chaos_1"	""	"True"
"character_trait_levels_colour_text_wh2_dlc09_trait_defeated_khatep"	""They say he can hold back death's cold embrace. I see little evidence of that this day!""	"True"
"character_trait_levels_onscreen_name_wh2_dlc09_trait_defeated_settra_as_surtha"	"True Chariot Master"	"True"
"character_trait_levels_colour_text_wh2_main_trait_def_name_of_power_co_07_bloodscourge"	""	"True"
"character_trait_levels_removal_text_wh_dlc07_trait_brt_lord_good_defeated_grimgor_1"	""	"True"
"character_trait_levels_colour_text_wh2_main_trait_razing_2"	"Carnage and butchery itself are meat and drink to this one; death on a grand scale provides their sustenance."	"True"
"character_trait_levels_colour_text_wh2_main_trait_razing_3"	""Lord of this wasteland, where my word is law - my bedfellows pestilence, famine and war!""	"True"
"character_trait_levels_colour_text_wh_dlc07_trait_brt_lord_good_peasants_1"	""Say what you will, but they die admirably in the service of their leader.""	"True"
"character_trait_levels_colour_text_wh2_main_trait_razing_1"	"This one will kill until everything that is yours becomes theirs. Even then, they will not stop until death intervenes."	"True"
"character_trait_levels_onscreen_name_wh2_main_trait_reinforcing_dark_elves"	"Likes Dark Elves"	"True"
"character_trait_levels_explanation_text_wh_dlc05_trait_name_dummy_morghur_1"	""	"True"
"character_trait_levels_onscreen_name_wh2_main_trait_defeated_helmen_ghorst"	"Ghorst or Ghost\?"	"True"
"character_trait_levels_onscreen_name_wh2_main_trait_reinforcing_lizardmen"	"Likes Lizardmen"	"True"
"character_trait_levels_removal_text_wh2_main_trait_agent_actions_against_greenskins"	""	"True"
"character_trait_levels_colour_text_wh2_main_trait_stance_ambushing"	"From above, below, or the shadows - this one knows when and where to strike."	"True"
"character_trait_levels_removal_text_wh2_main_trait_ruler_personality_morathi_dark_manipulator"	""	"True"
"character_trait_levels_removal_text_wh2_main_trait_reinforcing_lizardmen"	""	"True"
"character_trait_levels_removal_text_wh2_main_trait_defeated_prince_sigvald"	""	"True"
"character_trait_levels_colour_text_wh_main_trait_name_dummy_the_ever-watcher"	"."	"True"
"character_trait_levels_onscreen_name_wh2_main_trait_wins_against_wood_elves"	"Lords over Asrai"	"True"
"character_trait_levels_explanation_text_wh2_main_trait_black_ark_building_wh2_main_horde_def_slavery_1"	""	"True"
"character_trait_levels_explanation_text_wh2_main_trait_black_ark_building_wh2_main_horde_def_slavery_2"	""	"True"
"character_trait_levels_explanation_text_wh2_main_trait_black_ark_building_wh2_main_horde_def_slavery_3"	""	"True"
"character_trait_levels_onscreen_name_wh_dlc07_trait_brt_lord_bad_defender_1"	"Hesitant Defender"	"True"
"character_trait_levels_onscreen_name_wh_dlc07_trait_brt_lord_bad_defender_2"	"Poor Defender"	"True"
"character_trait_levels_onscreen_name_wh_dlc07_trait_brt_lord_bad_defender_3"	"Incompetent Defender"	"True"
"character_trait_levels_explanation_text_wh2_main_trait_defeated_alberic_de_bordeleaux"	"Defeated Alberic de Bordeleaux"	"True"
"character_trait_levels_removal_text_wh2_main_trait_reinforcing_humans"	""	"True"
"character_trait_levels_removal_text_wh2_main_trait_defeated_archaon_the_everchosen"	""	"True"
"character_trait_levels_explanation_text_wh2_main_trait_agent_action_hinder_replenishment"	"Carried out successful [[img:icon_hero]][[/img]]Hero actions"	"True"
"character_trait_levels_explanation_text_wh2_main_trait_skv_badly_mutated"	"Awarded through a Loyalty dilemma."	"True"
"character_trait_levels_removal_text_wh_dlc07_trait_brt_lord_good_defeated_archaon_1"	""	"True"
"character_trait_levels_onscreen_name_wh_dlc07_trait_brt_lord_good_defeated_manfred_1"	"Moonslaker"	"True"
"character_trait_levels_explanation_text_wh2_main_trait_skv_one_eye"	"Awarded through a Loyalty dilemma."	"True"
"character_trait_levels_removal_text_wh2_main_trait_wins_against_greenskins"	""	"True"
"character_trait_levels_colour_text_wh2_main_trait_def_name_of_power_co_11_drakecleaver"	""	"True"
"character_trait_levels_onscreen_name_wh2_main_trait_def_name_of_power_ar_09_granitestance"	"Name of Power: "Granitestance""	"True"
"character_trait_levels_colour_text_wh2_main_trait_def_name_of_power_ca_06_emeraldeye"	""	"True"
"character_trait_levels_onscreen_name_wh2_main_trait_defeats_against_vampires"	"Fears Vampires"	"True"
"character_trait_levels_removal_text_wh2_main_trait_sea_legs"	""	"True"
"character_trait_levels_colour_text_wh2_main_trait_def_name_of_power_ar_02_the_tempest_of_talons"	""	"True"
"character_trait_levels_explanation_text_wh2_main_trait_def_name_of_power_ca_08_pathguard"	""	"True"
"character_trait_levels_removal_text_wh2_main_trait_def_name_of_power_ar_09_granitestance"	""	"True"
"character_trait_levels_explanation_text_wh2_main_trait_reinforcing_beastmen"	"Reinforced Beastmen armies in battle multiple times"	"True"
"character_trait_levels_onscreen_name_wh_dlc07_trait_brt_lord_bad_defeat_2"	"Disgraced"	"True"
"character_trait_levels_colour_text_wh2_main_trait_agent_action_assault_units"	"\{\{tr:agent_action_assault_units_description}}"	"True"
"character_trait_levels_onscreen_name_wh_dlc07_trait_brt_lord_bad_defeat_1"	"Ashamed"	"True"
"character_trait_levels_removal_text_wh2_main_trait_def_name_of_power_ca_07_barbedlash"	""	"True"
"character_trait_levels_explanation_text_wh_main_trait_general_personality_vmp_black_arts_1"	""	"True"
"character_trait_levels_removal_text_wh_dlc07_trait_brt_lord_bad_defeat_1"	""	"True"
"character_trait_levels_removal_text_wh_dlc07_trait_brt_lord_bad_defeat_2"	""	"True"
"character_trait_levels_removal_text_wh_main_trait_name_dummy_ironhide"	""	"True"
"character_trait_levels_removal_text_wh_main_trait_name_dummy_suneater"	""	"True"
"character_trait_levels_colour_text_wh_dlc07_trait_brt_lord_good_beastmen_1"	""Most beasts bray, but all whimper before my might!""	"True"
"character_trait_levels_onscreen_name_wh2_main_trait_corrupted_chaos"	"Insane"	"True"
"character_trait_levels_colour_text_wh_dlc07_trait_brt_lord_bad_scared_of_greenskins_1"	""They came out of the ground, I tell you! They were everywhere; we couldn't stop 'em!""	"True"
"character_trait_levels_onscreen_name_wh2_main_trait_def_name_of_power_ca_05_leviathanrage"	"Name of Power: "Leviathanrage""	"True"
"character_trait_levels_colour_text_wh2_main_trait_def_name_of_power_co_04_headreaper"	""	"True"
"character_trait_levels_removal_text_wh2_main_trait_defeated_lord_mazdamundi"	""	"True"
"character_trait_levels_removal_text_wh2_main_trait_defeats_against_beastmen"	""	"True"
"character_trait_levels_removal_text_wh2_main_trait_defeated_morathi"	""	"True"
"character_trait_levels_removal_text_wh2_main_trait_def_name_of_power_ca_05_leviathanrage"	""	"True"
"character_trait_levels_colour_text_wh2_main_trait_stance_forced_march"	""Don't let them rest; an idle body is one ripe for corruption.""	"True"
"character_trait_levels_removal_text_wh2_main_trait_reinforcing_dwarfs"	""	"True"
"character_trait_levels_explanation_text_wh2_main_trait_slaver"	"Spent multiple turns in a region full of [[img:icon_slaves]][[/img]]slaves"	"True"
"character_trait_levels_explanation_text_wh2_main_trait_def_name_of_power_co_06_soulblaze"	""	"True"
"character_trait_levels_colour_text_wh2_main_trait_def_name_of_power_ca_03_khainemarked"	""	"True"
"character_trait_levels_onscreen_name_wh2_main_trait_def_name_of_power_ca_04_the_black_conqueror"	"Name of Power: "the Black Conqueror""	"True"
"character_trait_levels_explanation_text_wh2_main_trait_black_ark_building_wh2_main_horde_def_worship_1"	""	"True"
"character_trait_levels_onscreen_name_wh2_main_trait_defeated_mannfred_von_carstein"	"Moonslaker"	"True"
"character_trait_levels_explanation_text_wh2_main_trait_black_ark_building_wh2_main_horde_def_worship_2"	""	"True"
"character_trait_levels_removal_text_wh_dlc07_trait_brt_lord_good_praying_1"	""	"True"
"character_trait_levels_onscreen_name_wh2_main_trait_defeated_kholek_suneater"	"Stormblight"	"True"
"character_trait_levels_explanation_text_wh_dlc07_trait_brt_lord_good_lone_wolf_2"	"Gained by spending multiple turns in enemy regions"	"True"
"character_trait_levels_explanation_text_wh_dlc07_trait_brt_lord_good_lone_wolf_1"	"Gained by spending multiple turns in enemy regions"	"True"
"character_trait_levels_colour_text_wh_trait_dlc04_vlad_vanguard_not_shown"	"[Hidden] Vlad faction trait"	"True"
"character_trait_levels_explanation_text_wh2_main_trait_wins_against_humans"	"Achieved victory over Men multiple times"	"True"
"character_trait_levels_removal_text_wh2_main_trait_defeated_durthu"	""	"True"
"character_trait_levels_onscreen_name_wh_dlc07_trait_brt_lord_good_defeated_khazrak_1"	"Beastscourge"	"True"
"character_trait_levels_onscreen_name_wh_dlc03_trait_name_dummy_the_dark_omen"	""	"True"
"character_trait_levels_removal_text_wh2_main_trait_siege_victory_2"	""	"True"
"character_trait_levels_removal_text_wh2_main_trait_siege_victory_3"	""	"True"
"character_trait_levels_removal_text_wh2_main_trait_siege_victory_1"	""	"True"
"character_trait_levels_explanation_text_wh2_main_trait_defeats_against_dwarfs"	"Defeated by Dwarfs"	"True"
"character_trait_levels_onscreen_name_wh2_main_trait_defeats_at_sea_2"	"Poor Admiral"	"True"
"character_trait_levels_onscreen_name_wh2_main_trait_defeats_at_sea_3"	"Terrible Admiral"	"True"
"character_trait_levels_onscreen_name_wh2_main_trait_defeats_at_sea_1"	"Hydrophobe"	"True"
"character_trait_levels_removal_text_wh_dlc07_trait_brt_lord_good_sieging_3"	""	"True"
"character_trait_levels_removal_text_wh_dlc07_trait_brt_lord_good_sieging_2"	""	"True"
"character_trait_levels_removal_text_wh_dlc07_trait_brt_lord_good_sieging_1"	""	"True"
"character_trait_levels_colour_text_wh2_dlc09_trait_defeated_tretch"	"Turning and running away, under the auspices of coming back with reinforcements, is just running away â€“ and the mark of a coward to boot."	"True"
"character_trait_levels_colour_text_wh_dlc07_trait_brt_lord_good_defender_2"	"A good defender will maintain a secure perimeter and keep troops in reserve."	"True"
"character_trait_levels_colour_text_wh_dlc07_trait_brt_lord_good_defender_3"	"Nothing gets past."	"True"
"character_trait_levels_colour_text_wh_dlc07_trait_brt_lord_good_defender_1"	""I want bulwarks there and there. Start digging!""	"True"
"character_trait_levels_colour_text_wh2_main_trait_reinforcing_skaven"	"This being's liking for the dishonest, distrustful, double-dealing treachery of the Skaven speaks volumes about their own values."	"True"
"character_trait_levels_colour_text_wh_main_trait_name_dummy_ironfist"	"."	"True"
"character_trait_levels_explanation_text_wh2_main_trait_defeats_1"	"Suffered defeat in multiple battles"	"True"
"character_trait_levels_explanation_text_wh2_main_trait_defeats_3"	"Suffered defeat in multiple battles"	"True"
"character_trait_levels_explanation_text_wh2_main_trait_defeats_2"	"Suffered defeat in multiple battles"	"True"
"character_trait_levels_explanation_text_wh2_main_trait_agent_actions_against_dwarfs"	"Carried out successful [[img:icon_hero]][[/img]]Hero actions against Dwarfs"	"True"
"character_trait_levels_colour_text_wh2_main_trait_stance_tunneling"	""Where there's a wind, there's a wayâ€¦ and there's most definitely a wind down here...""	"True"
"character_trait_levels_removal_text_wh_main_trait_supreme_patriarch"	""	"True"
"character_trait_levels_colour_text_wh2_main_trait_def_name_of_power_co_08_griefbringer"	""	"True"
"character_trait_levels_removal_text_wh2_main_trait_stance_stalking"	""	"True"
"character_trait_levels_onscreen_name_wh2_main_trait_black_ark_building_wh2_main_horde_def_beasts_1"	""	"True"
"character_trait_levels_onscreen_name_wh2_main_trait_black_ark_building_wh2_main_horde_def_beasts_3"	""	"True"
"character_trait_levels_onscreen_name_wh2_main_trait_black_ark_building_wh2_main_horde_def_beasts_2"	""	"True"
"character_trait_levels_colour_text_wh_dlc06_trait_name_dummy_ironhammer"	""	"True"
"character_trait_levels_explanation_text_wh_dlc07_trait_brt_lord_bad_kingslayer_1"	"Gained by destroying Bretonnia"	"True"
"character_trait_levels_onscreen_name_wh2_main_trait_defeated_wurzzag"	"Great Green Killer"	"True"
"character_trait_levels_explanation_text_wh_main_trait_general_personality_vmp_dark_acolyte_1"	""	"True"
"character_trait_levels_explanation_text_wh2_main_trait_reinforcing"	"Reinforced your own forces multiple times"	"True"
"character_trait_levels_explanation_text_wh2_main_trait_wins_against_dwarfs"	"Achieved victory over Dwarfs multiple times"	"True"
"character_trait_levels_colour_text_wh2_main_trait_black_ark_building_wh2_main_horde_def_military_2"	""	"True"
"character_trait_levels_colour_text_wh2_main_trait_black_ark_building_wh2_main_horde_def_military_3"	""	"True"
"character_trait_levels_colour_text_wh2_main_trait_black_ark_building_wh2_main_horde_def_military_1"	""	"True"
"character_trait_levels_colour_text_wh_dlc03_trait_name_dummy_todbringer"	""	"True"
"character_trait_levels_onscreen_name_wh2_main_trait_agent_action_block_army"	"\{\{tr:agent_action_block_army_name}}"	"True"
"character_trait_levels_colour_text_wh2_main_trait_defeats_against_greenskins"	"The brutality of the Greenskins is to be rightly feared."	"True"
"character_trait_levels_onscreen_name_wh2_main_trait_corrupted_skaven"	"Skaven Denial"	"True"
"character_trait_levels_colour_text_wh2_main_trait_defeated_louen_leoncouer"	"This time, the king might well be dead. Oh well, long live the King!"	"True"
"character_trait_levels_explanation_text_wh2_main_trait_defeats_against_humans"	"Defeated by Men"	"True"
"character_trait_levels_onscreen_name_wh2_dlc09_trait_defeated_surtha_as_settra"	"Surtha Wrecked"	"True"
"character_trait_levels_onscreen_name_wh2_main_trait_wins_against_high_elves"	"Lords over Asur"	"True"
"character_trait_levels_removal_text_wh2_main_trait_def_name_of_power_ca_01_dreadtongue"	""	"True"
"character_trait_levels_onscreen_name_wh_dlc07_trait_brt_lord_bad_renegade_1"	"Renegade"	"True"
"character_trait_levels_colour_text_wh2_main_trait_def_name_of_power_co_05_spiteheart"	""	"True"
"character_trait_levels_explanation_text_wh2_main_trait_agent_action_damage_walls"	""	"True"
"character_trait_levels_onscreen_name_wh2_main_trait_defeated_fay_enchantress"	"Witchfinder General"	"True"
"character_trait_levels_removal_text_wh2_main_trait_agent_action_assassinate"	""	"True"
"character_trait_levels_onscreen_name_wh2_main_trait_skv_musk_of_the_overlord"	"Overlord's Musk"	"True"
"character_trait_levels_explanation_text_wh2_main_trait_reinforcing_chaos"	"Reinforced Chaos armies in battle multiple times"	"True"
"character_trait_levels_explanation_text_wh2_main_trait_def_name_of_power_ar_04_barbstorm"	""	"True"
"character_trait_levels_colour_text_wh2_main_trait_lone_wolf_1"	"The tree that grows alone grows stronger for it."	"True"
"character_trait_levels_colour_text_wh2_main_trait_lone_wolf_3"	"Prowling. Waiting. Patient. Alone. Deadly."	"True"
"character_trait_levels_colour_text_wh2_main_trait_lone_wolf_2"	"I alone can fix this; I alone."	"True"
"character_trait_levels_colour_text_wh2_main_trait_def_name_of_power_ar_07_wrathbringer"	""	"True"
"character_trait_levels_removal_text_wh2_main_trait_def_name_of_power_ar_11_krakenclaw"	""	"True"
"character_trait_levels_colour_text_wh_main_trait_name_dummy_the_everchosen"	"."	"True"
"character_trait_levels_explanation_text_wh_main_trait_name_dummy_leoncoeur"	""	"True"
"character_trait_levels_explanation_text_wh2_main_trait_agent_actions_against_humans"	"Carried out successful [[img:icon_hero]][[/img]]Hero actions against Men"	"True"
"character_trait_levels_explanation_text_wh2_main_trait_agent_target_fail_1"	"Was the target of unsuccessful [[img:icon_hero]][[/img]]Hero actions"	"True"
"character_trait_levels_explanation_text_wh2_main_trait_agent_target_fail_3"	"Was the target of unsuccessful [[img:icon_hero]][[/img]]Hero actions"	"True"
"character_trait_levels_explanation_text_wh2_main_trait_agent_target_fail_2"	"Was the target of unsuccessful [[img:icon_hero]][[/img]]Hero actions"	"True"
"character_trait_levels_colour_text_wh2_main_trait_agent_actions_against_dark_elves"	""Their cruelty is without match, their villainy without end. Don't even get me started on their hair.""	"True"
"character_trait_levels_colour_text_wh2_main_trait_def_name_of_power_co_01_blackstone"	""	"True"
"character_trait_levels_colour_text_wh_dlc07_trait_brt_lord_bad_raider_1"	""Our lands provide for all; THIS land provides for ME!""	"True"
"character_trait_levels_explanation_text_wh2_main_trait_defeated_grombrindal"	"Defeated Grombrindal"	"True"
"character_trait_levels_explanation_text_wh2_main_trait_def_assassins_end"	"Awarded through a Loyalty dilemma."	"True"
"character_trait_levels_removal_text_wh2_main_trait_defeated_ungrim_ironfist"	""	"True"
"character_trait_levels_removal_text_wh2_main_trait_def_name_of_power_ar_03_shadowdart"	""	"True"
"character_trait_levels_colour_text_wh2_main_trait_ruler_personality_tiranoc_chariots"	"Magnificent chariots, gifted to those who have impressed with their devotion, bravery and prowess in battle."	"True"
"character_trait_levels_onscreen_name_wh2_main_trait_non_corrupted"	"Uncorrupted"	"True"
"character_trait_levels_removal_text_wh2_main_trait_defeated_khazrak_one_eye"	""	"True"
"character_trait_levels_explanation_text_wh2_main_trait_agent_actions_against_vampires"	"Carried out successful [[img:icon_hero]][[/img]]Hero actions against Vampire Counts"	"True"
"character_trait_levels_colour_text_wh2_main_trait_def_name_of_power_co_12_hydrablood"	""	"True"
"character_trait_levels_removal_text_wh2_main_trait_far_from_capital"	""	"True"
"character_trait_levels_removal_text_wh2_main_trait_non_corrupted"	""	"True"
"character_trait_levels_explanation_text_wh2_dlc09_trait_patience"	"Gained from quest"	"True"
"character_trait_levels_onscreen_name_wh2_main_trait_def_name_of_power_ar_02_the_tempest_of_talons"	"Name of Power: "the Tempest of Talons""	"True"
"character_trait_levels_onscreen_name_wh2_main_trait_defeated_azhag_the_slaughterer"	"Greenskinner"	"True"
"character_trait_levels_onscreen_name_wh2_main_trait_defeated_ungrim_ironfist"	"Slayer King Slayer"	"True"
"character_trait_levels_colour_text_wh2_main_trait_def_name_of_power_ar_09_granitestance"	""	"True"
"character_trait_levels_removal_text_wh2_main_trait_def_name_of_power_ar_02_the_tempest_of_talons"	""	"True"
"character_trait_levels_onscreen_name_wh2_main_trait_wins_against_dark_elves"	"Lords over Druchii"	"True"
"character_trait_levels_removal_text_wh2_main_trait_def_name_of_power_co_10_fatedshield"	""	"True"
"character_trait_levels_onscreen_name_wh2_main_trait_defeated_khazrak_one_eye"	"Beastscourge"	"True"
"character_trait_levels_colour_text_wh_dlc07_trait_brt_lord_bad_defeat_1"	"Honour and chivalry are important tools, but skill in battle is perhaps the most crucial."	"True"
"character_trait_levels_colour_text_wh_dlc07_trait_brt_lord_bad_defeat_2"	"A lifetime of setbacks leaves one bitter, forlorn and, importantly, ill-regarded."	"True"
"character_trait_levels_explanation_text_wh2_main_trait_def_name_of_power_co_02_wyrmscale"	""	"True"
"character_trait_levels_onscreen_name_wh2_main_trait_far_from_capital"	"Campaigner"	"True"
"character_trait_levels_onscreen_name_wh2_main_trait_lazy_1"	"Procrastinator"	"True"
"character_trait_levels_onscreen_name_wh2_main_trait_lazy_2"	"Lazy"	"True"
"character_trait_levels_onscreen_name_wh2_main_trait_lazy_3"	"Indolent"	"True"
"character_trait_levels_colour_text_wh_dlc07_trait_brt_lord_good_attacker_1"	"Confidence - the key to a successful battlefield action."	"True"
"character_trait_levels_colour_text_wh_dlc07_trait_brt_lord_good_attacker_2"	"A good attack requires skilled warriors and superior numbers."	"True"
"character_trait_levels_colour_text_wh_dlc07_trait_brt_lord_good_attacker_3"	"Superior generalship and battlefield acumen is needed in war."	"True"
"character_trait_levels_onscreen_name_wh2_main_trait_reinforcing_wood_elves"	"Likes Wood Elves"	"True"
"character_trait_levels_colour_text_wh2_main_trait_defeated_karl_franz"	"Even great men are flawed; failure is part of mankind's tragic condition."	"True"
"character_trait_levels_removal_text_wh2_main_trait_corrupted_skaven"	""	"True"
"character_trait_levels_explanation_text_wh_main_trait_name_dummy_von_carstein"	""	"True"
"character_trait_levels_colour_text_wh2_main_trait_agent_actions_against_high_elves"	""They speak of fairness in their high-handed manner, but ultimately it means nothing - if you're not Asur, you're scum.""	"True"
"character_trait_levels_colour_text_wh2_main_trait_def_name_of_power_ca_05_leviathanrage"	""	"True"
"character_trait_levels_removal_text_wh_main_trait_name_dummy_ironfist"	""	"True"
"character_trait_levels_removal_text_wh2_main_trait_reinforcing_skaven"	""	"True"
"character_trait_levels_explanation_text_wh2_dlc09_trait_merciless"	"Gained from quest"	"True"
"character_trait_levels_colour_text_wh_dlc07_trait_brt_lord_good_knightly_1"	"There is no substitute for the nobility, rigour, and honour of Bretonnian aristocracy."	"True"
"character_trait_levels_removal_text_wh2_main_trait_def_name_of_power_ar_10_the_grey_vanquisher"	""	"True"
"character_trait_levels_explanation_text_wh2_main_trait_builder_2"	"Present in regions during building construction"	"True"
"character_trait_levels_explanation_text_wh2_main_trait_builder_3"	"Present in regions during building construction"	"True"
"character_trait_levels_explanation_text_wh2_main_trait_builder_1"	"Present in regions during building construction"	"True"
"character_trait_levels_removal_text_wh_dlc07_trait_brt_lord_good_farming_1"	""	"True"
"character_trait_levels_explanation_text_wh2_main_trait_agent_actions_against_beastmen"	"Carried out successful [[img:icon_hero]][[/img]]Hero actions against Beastmen"	"True"
"character_trait_levels_explanation_text_wh2_main_trait_attacking_victory_1"	"Achieved victory from multiple offensive battles"	"True"
"character_trait_levels_explanation_text_wh2_main_trait_attacking_victory_2"	"Achieved victory from multiple offensive battles"	"True"
"character_trait_levels_explanation_text_wh2_main_trait_attacking_victory_3"	"Achieved victory from multiple offensive battles"	"True"
"character_trait_levels_onscreen_name_wh2_main_trait_agent_action_assassinate"	"\{\{tr:agent_action_assassinate_name}}"	"True"
"character_trait_levels_removal_text_wh2_main_trait_defeated_fay_enchantress"	""	"True"
"character_trait_levels_removal_text_wh2_main_trait_skv_musk_of_the_overlord"	""	"True"
"character_trait_levels_explanation_text_wh_dlc07_trait_brt_lord_good_executing_1"	"Gained by executing captives"	"True"
"character_trait_levels_colour_text_wh_dlc07_trait_brt_lord_bad_lazy_1"	"Thinking about something is not the same as doing it."	"True"
"character_trait_levels_colour_text_wh_dlc07_trait_brt_lord_bad_lazy_2"	""Why should I stir\? Do my followers not work in my stead\?""	"True"
"character_trait_levels_onscreen_name_wh_dlc07_trait_brt_lord_bad_coward_1"	"Coward"	"True"
"character_trait_levels_explanation_text_wh2_main_trait_agent_target_success_1"	"Was the target of successful [[img:icon_hero]][[/img]]Hero actions"	"True"
"character_trait_levels_explanation_text_wh2_main_trait_agent_target_success_3"	"Was the target of successful [[img:icon_hero]][[/img]]Hero actions"	"True"
"character_trait_levels_explanation_text_wh2_main_trait_agent_target_success_2"	"Was the target of successful [[img:icon_hero]][[/img]]Hero actions"	"True"
"character_trait_levels_explanation_text_wh2_main_trait_sacking_2"	"Sacked multiple settlements"	"True"
"character_trait_levels_explanation_text_wh2_main_trait_sacking_3"	"Sacked multiple settlements"	"True"
"character_trait_levels_explanation_text_wh2_main_trait_sacking_1"	"Sacked multiple settlements"	"True"
"character_trait_levels_colour_text_wh2_main_trait_ruler_personality_kroq_gar_ancient_spawn"	"The spawning that brought Kroq-Gar into the world produced a handful of Saurus, each marked for greatness."	"True"
"character_trait_levels_removal_text_wh_dlc07_trait_brt_lord_bad_coward_1"	""	"True"
"character_trait_levels_removal_text_wh2_main_trait_defeats_against_greenskins"	""	"True"
"character_trait_levels_colour_text_wh_dlc07_trait_brt_lord_good_chaos_1"	"Dark, corrupting, evil forces have no place here!"	"True"
"character_trait_levels_explanation_text_wh2_main_trait_agent_action_damage_building"	""	"True"
"character_trait_levels_onscreen_name_wh_main_trait_supreme_patriarch"	"Supreme Patriarch"	"True"
"character_trait_levels_onscreen_name_wh2_main_trait_agent_actions_against_lizardmen"	"Hates Lizardmen"	"True"
"character_trait_levels_removal_text_wh2_main_trait_def_name_of_power_co_05_spiteheart"	""	"True"
"character_trait_levels_onscreen_name_wh2_main_trait_defeated_thorgrim_grudgebearer"	"Grudgekiller"	"True"
"character_trait_levels_explanation_text_wh2_main_trait_post_battle_execute"	"Executed captives after battle multiple times"	"True"
"character_trait_levels_removal_text_wh2_main_trait_defeated_wurzzag"	""	"True"
"character_trait_levels_explanation_text_wh_main_trait_name_dummy_grudgebearer"	""	"True"
"character_trait_levels_colour_text_wh2_main_trait_reinforcing_lizardmen"	""I like them - they've got a plan and are absolutely assured of it. The way I see it, you want to be on the winning side, no\?""	"True"
"character_trait_levels_removal_text_wh2_main_trait_def_name_of_power_co_01_blackstone"	""	"True"
"character_trait_levels_removal_text_wh_dlc07_trait_brt_lord_good_defeated_khazrak_1"	""	"True"
"character_trait_levels_removal_text_wh_main_trait_name_dummy_franz"	""	"True"
"character_trait_levels_removal_text_wh_main_trait_name_dummy_blank"	""	"True"
"character_trait_levels_colour_text_wh2_main_trait_def_name_of_power_ar_11_krakenclaw"	""	"True"
"character_trait_levels_removal_text_wh_dlc03_trait_name_dummy_the_dark_omen"	""	"True"
"character_trait_levels_explanation_text_wh_dlc07_trait_brt_lord_good_greenskins_1"	"Gained by winning battles against Greenskin factions"	"True"
"character_trait_levels_onscreen_name_wh2_main_trait_public_order_3"	"Authoritarian"	"True"
"character_trait_levels_onscreen_name_wh2_main_trait_public_order_2"	"Severe"	"True"
"character_trait_levels_onscreen_name_wh2_main_trait_public_order_1"	"Strict"	"True"
"character_trait_levels_removal_text_wh2_main_trait_def_name_of_power_co_12_hydrablood"	""	"True"
"character_trait_levels_onscreen_name_wh2_main_trait_defeated_malagor_the_dark_omen"	"Crowreaver"	"True"
"character_trait_levels_colour_text_wh_dlc06_clan_angrund_ancestor_runesmith_1"	"The Master Runesmith stands by his Lord â€“ his kin â€“ one last time before the gods."	"True"
"character_trait_levels_explanation_text_wh2_main_trait_fighter_2"	"Was personally involved in combat during battles"	"True"
"character_trait_levels_explanation_text_wh2_main_trait_fighter_3"	"Was personally involved in combat during battles"	"True"
"character_trait_levels_explanation_text_wh2_main_trait_fighter_1"	"Was personally involved in combat during battles"	"True"
"character_trait_levels_onscreen_name_wh2_main_trait_defeated_orion"	"Wildhunter"	"True"
"character_trait_levels_explanation_text_wh2_main_trait_black_ark_building_wh2_main_horde_def_sorcery_1"	""	"True"
"character_trait_levels_explanation_text_wh2_main_trait_black_ark_building_wh2_main_horde_def_sorcery_2"	""	"True"
"character_trait_levels_removal_text_wh2_main_trait_defeats_at_sea_2"	""	"True"
"character_trait_levels_removal_text_wh2_main_trait_defeats_at_sea_3"	""	"True"
"character_trait_levels_removal_text_wh2_main_trait_defeats_at_sea_1"	""	"True"
"character_trait_levels_removal_text_wh2_main_trait_ruler_personality_tiranoc_chariots"	""	"True"
"character_trait_levels_onscreen_name_wh_dlc06_clan_angrund_ancestor_thane_1"	"Clan Angrund Ancestor"	"True"
"character_trait_levels_colour_text_wh2_main_trait_def_name_of_power_ar_03_shadowdart"	""	"True"
"character_trait_levels_removal_text_wh2_main_trait_routed_3"	""	"True"
"character_trait_levels_removal_text_wh2_main_trait_routed_2"	""	"True"
"character_trait_levels_removal_text_wh2_main_trait_routed_1"	""	"True"
"character_trait_levels_explanation_text_wh2_dlc09_trait_settra_title_3"	"Faction has a [[img:icon_treasury]][[/img]]treasury of 200,000"	"True"
"character_trait_levels_onscreen_name_wh2_main_trait_wins_against_greenskins"	"Orcsbane"	"True"
"character_trait_levels_explanation_text_wh2_dlc09_trait_settra_title_2"	"Faction has a [[img:icon_treasury]][[/img]]treasury of 100,000"	"True"
"character_trait_levels_explanation_text_wh2_dlc09_trait_settra_title_1"	"Faction has a [[img:icon_treasury]][[/img]]treasury of 50,000"	"True"
"character_trait_levels_colour_text_wh_dlc04_trait_name_dummy_the_grim"	""	"True"
"character_trait_levels_explanation_text_wh2_main_trait_defeats_against_lizardmen"	"Defeated by Lizardmen"	"True"
"character_trait_levels_onscreen_name_wh2_dlc09_trait_defeated_khatep"	"Not So Grand Hierophant"	"True"
"character_trait_levels_removal_text_wh2_dlc09_trait_defeated_arkhan"	""	"True"
"character_trait_levels_removal_text_wh_dlc07_trait_brt_lord_good_vampires_1"	""	"True"
"character_trait_levels_onscreen_name_wh2_main_trait_def_name_of_power_co_07_bloodscourge"	"Name of Power: "Bloodscourge""	"True"
"character_trait_levels_colour_text_wh_dlc07_trait_brt_lord_bad_sacking_1"	"Find the baubles of the dead and dying, take them for your own!"	"True"
"character_trait_levels_onscreen_name_wh2_main_trait_razing_2"	"Slaughterer"	"True"
"character_trait_levels_onscreen_name_wh2_main_trait_razing_3"	"Annihilator"	"True"
"character_trait_levels_onscreen_name_wh_dlc07_trait_brt_lord_good_peasants_1"	"Low-Born"	"True"
"character_trait_levels_colour_text_wh_dlc07_trait_brt_lord_bad_sacking_3"	""Find me their trinkets and things, I will take them all.""	"True"
"character_trait_levels_colour_text_wh_dlc07_trait_brt_lord_bad_sacking_2"	"Slicing fingers to get at rings, or heads to free bodies from prized armour - this one is a butcher!"	"True"
"character_trait_levels_onscreen_name_wh2_main_trait_razing_1"	"Despoiler"	"True"
"character_trait_levels_colour_text_wh2_main_trait_defeats_against_high_elves"	""So aloof, so whiter-than-white. And That hair! They give me the willies! You can keep 'em!""	"True"
"character_trait_levels_explanation_text_wh2_main_trait_defeated_skarsnik"	"Defeated Skarsnik"	"True"
"character_trait_levels_colour_text_wh2_main_trait_wins_against_skaven"	""Skaven are a disease, a cancer on this worldâ€¦ You are a plague and we are the cureâ€¦""	"True"
"character_trait_levels_colour_text_wh2_main_trait_defeated_belegar_ironhammer"	"The True King lies defeated but will return, spitting oaths and even grumpier than before!"	"True"
"character_trait_levels_removal_text_wh2_main_trait_agent_action_wound"	""	"True"
"character_trait_levels_onscreen_name_wh2_main_trait_stance_ambushing"	"Ambusher"	"True"
"character_trait_levels_removal_text_wh2_dlc09_trait_defeated_settra"	""	"True"
"character_trait_levels_explanation_text_wh2_main_trait_black_ark_building_wh2_main_horde_def_beasts_1"	""	"True"
"character_trait_levels_explanation_text_wh2_main_trait_black_ark_building_wh2_main_horde_def_beasts_2"	""	"True"
"character_trait_levels_explanation_text_wh2_main_trait_black_ark_building_wh2_main_horde_def_beasts_3"	""	"True"
"character_trait_levels_removal_text_wh2_main_trait_corrupted_chaos"	""	"True"
"character_trait_levels_onscreen_name_wh2_main_trait_defeats_against_dwarfs"	"Fears Dwarfs"	"True"
"character_trait_levels_removal_text_wh2_main_trait_defeated_queen_headtaker"	""	"True"
"character_trait_levels_colour_text_wh_dlc06_clan_angrund_ancestor_thane_other_1"	""No Troll, no Orc, no sneaky grobi scum shall bar my path. This timeâ€¦""	"True"
"character_trait_levels_colour_text_wh_dlc07_trait_brt_lord_bad_traitor_1"	"Craven is he who raises his sword against the Lady's chosen. Skilled, perhaps, but craven all the same."	"True"
"character_trait_levels_removal_text_wh2_main_trait_def_name_of_power_ca_04_the_black_conqueror"	""	"True"
"character_trait_levels_explanation_text_wh2_main_trait_defeated_heinrich_kemmler"	"Defeated Heinrich Kemmler"	"True"
"character_trait_levels_removal_text_wh2_main_trait_agent_actions_against_wood_elves"	""	"True"
"character_trait_levels_onscreen_name_wh_dlc07_trait_brt_lord_good_praying_1"	"Devoted"	"True"
"character_trait_levels_removal_text_wh_main_trait_name_dummy_the_magnificent"	""	"True"
"character_trait_levels_onscreen_name_wh2_main_trait_def_name_of_power_co_11_drakecleaver"	"Name of Power: "Drakecleaver""	"True"
"character_trait_levels_colour_text_wh_dlc07_trait_brt_lord_good_defeated_manfred_1"	"He who quenches his thirst on the blood of the living will find cold steel his just reward."	"True"
"character_trait_levels_removal_text_wh_dlc07_trait_brt_lord_good_industry_1"	""	"True"
"character_trait_levels_colour_text_wh2_main_trait_defending_victory_2"	"A good defender will maintain a secure perimeter and keep troops in reserve."	"True"
"character_trait_levels_colour_text_wh2_main_trait_defending_victory_3"	"Nothing gets past."	"True"
"character_trait_levels_colour_text_wh2_main_trait_defending_victory_1"	"I want bulwarks there and there. Start digging!"	"True"
"character_trait_levels_onscreen_name_wh2_main_trait_agent_action_steal_technology"	"\{\{tr:agent_action_steal_technology_name}}"	"True"
"character_trait_levels_onscreen_name_wh2_main_trait_brutally_honest"	"Brutally Honest"	"True"
"character_trait_levels_onscreen_name_wh2_main_trait_defeated_balthasar_gelt"	"Metalstorm"	"True"
"character_trait_levels_removal_text_wh2_main_trait_agent_action_steal_technology"	""	"True"
"character_trait_levels_explanation_text_wh_dlc06_clan_angrund_ancestor_master_engineer_1"	""	"True"
"character_trait_levels_onscreen_name_wh_main_trait_name_dummy_the_magnificent"	"."	"True"
"character_trait_levels_colour_text_wh2_main_trait_defeats_against_vampires"	"You are right to fear the Undead, for they wish an Unliving hell on us all!"	"True"
"character_trait_levels_removal_text_wh_main_trait_name_dummy_kemmler"	""	"True"
"character_trait_levels_onscreen_name_wh2_main_trait_agent_actions_against_vampires"	"Hates Vampires"	"True"
"character_trait_levels_removal_text_wh2_main_trait_defending_defeat_2"	""	"True"
"character_trait_levels_removal_text_wh2_main_trait_defending_defeat_3"	""	"True"
"character_trait_levels_removal_text_wh2_main_trait_defending_defeat_1"	""	"True"
"character_trait_levels_removal_text_wh_dlc07_trait_brt_lord_bad_sieging_1"	""	"True"
"character_trait_levels_removal_text_wh_dlc07_trait_brt_lord_bad_sieging_3"	""	"True"
"character_trait_levels_removal_text_wh_dlc07_trait_brt_lord_bad_sieging_2"	""	"True"
"character_trait_levels_onscreen_name_wh_main_trait_name_dummy_kemmler"	"."	"True"
"character_trait_levels_colour_text_wh2_main_trait_attacking_defeat_1"	"Which battlefield\?"	"True"
"character_trait_levels_colour_text_wh2_main_trait_attacking_defeat_2"	"Strike hard and fast or not at all."	"True"
"character_trait_levels_colour_text_wh2_main_trait_attacking_defeat_3"	"The gods do not look favourably on failure."	"True"
"character_trait_levels_removal_text_wh2_main_trait_defeats_against_dark_elves"	""	"True"
"character_trait_levels_explanation_text_wh2_main_trait_agent_action_assault_unit"	"Carried out successful [[img:icon_hero]][[/img]]Hero actions"	"True"
"character_trait_levels_explanation_text_wh2_main_trait_stance_channeling"	"Spent multiple turns in Channelling stance"	"True"
"character_trait_levels_colour_text_wh2_main_trait_wins_against_vampires"	"No servant of the Midnight Aristocracy dares stand against the veteran slayer."	"True"
"character_trait_levels_onscreen_name_wh2_main_trait_defeated_prince_sigvald"	"Pride Assassin"	"True"
"character_trait_levels_colour_text_wh_dlc07_trait_brt_lord_bad_villain_1"	"Gilles the Uniter would weep to see such brazen disobedience among his dukedoms."	"True"
"character_trait_levels_removal_text_wh2_main_trait_wins_against_wood_elves"	""	"True"
"character_trait_levels_removal_text_wh2_main_trait_def_name_of_power_ar_01_lifequencher"	""	"True"
"character_trait_levels_onscreen_name_wh_dlc07_trait_brt_lord_good_beastmen_1"	"Beast Tamer"	"True"
"character_trait_levels_onscreen_name_wh2_main_trait_agent_action_assault_garrison"	"\{\{tr:agent_action_assault_garrison_name}}"	"True"
"character_trait_levels_removal_text_wh2_dlc09_dummy_trait_dynasty_3"	""	"True"
"character_trait_levels_removal_text_wh2_dlc09_dummy_trait_dynasty_2"	""	"True"
"character_trait_levels_onscreen_name_wh2_main_trait_defeats_against_humans"	"Fears Men"	"True"
"character_trait_levels_removal_text_wh2_dlc09_dummy_trait_dynasty_1"	""	"True"
"character_trait_levels_removal_text_wh2_dlc09_dummy_trait_dynasty_6"	""	"True"
"character_trait_levels_removal_text_wh2_dlc09_dummy_trait_dynasty_5"	""	"True"
"character_trait_levels_removal_text_wh2_dlc09_dummy_trait_dynasty_4"	""	"True"
"character_trait_levels_removal_text_wh_dlc07_trait_brt_lord_bad_defender_2"	""	"True"
"character_trait_levels_removal_text_wh_dlc07_trait_brt_lord_bad_defender_3"	""	"True"
"character_trait_levels_removal_text_wh_dlc07_trait_brt_lord_bad_defender_1"	""	"True"
"character_trait_levels_explanation_text_wh2_dlc09_trait_benevolence"	"Gained from quest"	"True"
"character_trait_levels_removal_text_wh2_main_trait_agent_action_assault_garrison"	""	"True"
"character_trait_levels_colour_text_wh_dlc07_trait_brt_lord_good_reinforcing_1"	"The legends tell of heroes riding to an eleventh-hour salvation. The legends are real."	"True"
"character_trait_levels_onscreen_name_wh2_main_trait_def_name_of_power_ca_03_khainemarked"	"Name of Power: "Khainemarked""	"True"
"character_trait_levels_explanation_text_wh2_main_trait_agent_actions_against_chaos"	"Carried out successful [[img:icon_hero]][[/img]]Hero actions against Chaos"	"True"
"character_trait_levels_onscreen_name_wh2_main_trait_defeated_archaon_the_everchosen"	"Doomslayer"	"True"
"character_trait_levels_removal_text_wh_dlc07_trait_brt_lord_bad_perverted_1"	""	"True"
"character_trait_levels_explanation_text_wh2_dlc09_trait_defeated_surtha_as_settra"	"Settra the Imperishable defeated Surtha Ek"	"True"
"character_trait_levels_explanation_text_wh2_main_trait_defeated_kroq_gar"	"Defeated Kroq-Gar"	"True"
"character_trait_levels_colour_text_wh2_main_trait_defeated_kholek_suneater"	"Roiling skies, raging winds, and lightning didn't help the Herald of the Tempest, laid low this day by honest steel."	"True"
"character_trait_levels_onscreen_name_wh_main_trait_name_dummy_von_carstein"	"."	"True"
"character_trait_levels_onscreen_name_wh_main_trait_general_personality_vmp_summon_creatures_1"	"Summon Creatures of the Night"	"True"
"character_trait_levels_onscreen_name_wh2_main_trait_def_name_of_power_ar_01_lifequencher"	"Name of Power: "Lifequencher""	"True"
"character_trait_levels_removal_text_wh_dlc07_trait_brt_lord_good_beastmen_1"	""	"True"
"character_trait_levels_onscreen_name_wh2_main_trait_def_name_of_power_ar_05_beastbinder"	"Name of Power: "Beastbinder""	"True"
"character_trait_levels_onscreen_name_wh2_dlc09_trait_merciless"	"Ruthless Leader"	"True"
"character_trait_levels_onscreen_name_wh2_dlc09_dummy_trait_dynasty_3"	"Thutep of the Third Dynasty"	"True"
"character_trait_levels_onscreen_name_wh2_dlc09_dummy_trait_dynasty_2"	"Rakhash of the Second Dynasty"	"True"
"character_trait_levels_onscreen_name_wh2_dlc09_dummy_trait_dynasty_1"	"Wakhaf of the First Dynasty"	"True"
"character_trait_levels_onscreen_name_wh2_dlc09_dummy_trait_dynasty_6"	"Alkhazzar II of the Sixth Dynasty"	"True"
"character_trait_levels_onscreen_name_wh2_dlc09_dummy_trait_dynasty_5"	"Setep of the Fifth Dynasty"	"True"
"character_trait_levels_onscreen_name_wh2_dlc09_dummy_trait_dynasty_4"	"Lahmizzash of the Fourth Dynasty"	"True"
"character_trait_levels_colour_text_wh2_main_trait_defeats_against_beastmen"	"The only survivor of a meeting with the herd; naturally, the rest all died in screaming agony. It's going to have an effectâ€¦"	"True"
"character_trait_levels_colour_text_wh2_main_trait_ruler_personality_malekith_witch_king"	"The Witch King long ago sought to take Ulthuan's crown, but the Flames of Asuryan left him twisted with hatred and horribly scarred."	"True"
"character_trait_levels_colour_text_wh2_main_trait_defeated_lord_mazdamundi"	"It would seem that the lizard king can't always do everything; winning, for instance."	"True"
"character_trait_levels_colour_text_wh2_main_trait_defeated_morathi"	"Her Dark Magic, Daemonic pacts, and evil ways have counted for naught in the face of superior arms."	"True"
"character_trait_levels_removal_text_wh_main_trait_general_personality_vmp_summon_creatures_1"	""	"True"
"character_trait_levels_explanation_text_wh2_main_trait_reinforcing_wood_elves"	"Reinforced Wood Elf armies in battle multiple times"	"True"
"character_trait_levels_colour_text_wh2_main_trait_defeats_against_chaos"	""The Ruinous Powers will be our undoing!""	"True"
"character_trait_levels_colour_text_wh2_main_trait_def_name_of_power_ca_12_the_tormentor"	""	"True"
"character_trait_levels_colour_text_wh2_main_trait_agent_action_wound"	"\{\{tr:agent_action_wound_description}}"	"True"
"character_trait_levels_removal_text_wh2_main_trait_def_name_of_power_ca_03_khainemarked"	""	"True"
"character_trait_levels_removal_text_wh2_main_trait_ruler_personality_queek_hates_dwarfs_greenskins"	""	"True"
"character_trait_levels_onscreen_name_wh_dlc07_trait_brt_lord_bad_perverted_1"	"Perverted"	"True"
"character_trait_levels_onscreen_name_wh2_main_trait_agent_actions_against_beastmen"	"Hates Beastmen"	"True"
"character_trait_levels_removal_text_wh_dlc07_trait_brt_lord_bad_sacking_1"	""	"True"
"character_trait_levels_removal_text_wh_dlc07_trait_brt_lord_bad_sacking_3"	""	"True"
"character_trait_levels_removal_text_wh_dlc07_trait_brt_lord_bad_sacking_2"	""	"True"
"character_trait_levels_colour_text_wh2_main_trait_wins_against_beastmen"	""Most beasts bray, but all whimper before my might!""	"True"
"character_trait_levels_removal_text_wh2_main_trait_defeats_against_high_elves"	""	"True"
"character_trait_levels_removal_text_wh2_main_trait_def_name_of_power_co_11_drakecleaver"	""	"True"
"character_trait_levels_onscreen_name_wh_dlc07_trait_brt_lord_good_industry_1"	"Industrialist"	"True"
"character_trait_levels_colour_text_wh_dlc07_trait_brt_lord_good_defeated_archaon_1"	"The Everchosen may rise and rise again, but he will forever be consigned to oblivion!"	"True"
"character_trait_levels_colour_text_wh2_main_trait_black_ark_building_wh2_main_horde_def_entertainment_2"	""	"True"
"character_trait_levels_colour_text_wh2_main_trait_black_ark_building_wh2_main_horde_def_entertainment_3"	""	"True"
"character_trait_levels_colour_text_wh2_main_trait_black_ark_building_wh2_main_horde_def_entertainment_1"	""	"True"
"character_trait_levels_onscreen_name_wh_main_trait_all_personality_all_hates_dwarfs_1"	"Hates Dwarfs"	"True"
"character_trait_levels_removal_text_wh_main_trait_all_personality_all_hates_dwarfs_1"	""	"True"
"character_trait_levels_explanation_text_wh2_main_trait_exploring"	"Visited all of the world's landmarks"	"True"
"character_trait_levels_explanation_text_wh2_main_trait_defeated_azhag_the_slaughterer"	"Defeated Azhag the Slaughterer"	"True"
"character_trait_levels_colour_text_wh2_main_trait_sea_legs"	"If you can keep your lunch down whilst everyone around you is losing theirs, then the navy is the place for you."	"True"
"character_trait_levels_onscreen_name_wh2_main_trait_defeated_tyrion"	"Ulthuan Undefended"	"True"
"character_trait_levels_onscreen_name_wh2_main_trait_wounded"	"Paranoid"	"True"
"character_trait_levels_explanation_text_wh_dlc07_trait_brt_lord_good_public_order_1"	"Gained by being in a region with low public order"	"True"
"character_trait_levels_onscreen_name_wh2_main_trait_defeated_morghur_the_shadowgave"	"Skullslasher"	"True"
"character_trait_levels_explanation_text_wh2_main_trait_lazy_1"	"Spent too long in an owned settlement with high [[img:icon_public_order]][[/img]]\{\{tr:hp_campaign_public_order_term}}"	"True"
"character_trait_levels_onscreen_name_wh2_main_trait_skv_flayed_tail"	"Flayed Tail"	"True"
"character_trait_levels_explanation_text_wh2_main_trait_lazy_3"	"Spent too long in an owned settlement with high [[img:icon_public_order]][[/img]]\{\{tr:hp_campaign_public_order_term}}"	"True"
"character_trait_levels_explanation_text_wh2_main_trait_lazy_2"	"Spent too long in an owned settlement with high [[img:icon_public_order]][[/img]]\{\{tr:hp_campaign_public_order_term}}"	"True"
"character_trait_levels_removal_text_wh_dlc07_trait_brt_lord_bad_traitor_1"	""	"True"
"character_trait_levels_colour_text_wh2_main_trait_black_ark_building_wh2_main_horde_def_slavery_1"	""	"True"
"character_trait_levels_colour_text_wh2_main_trait_black_ark_building_wh2_main_horde_def_slavery_2"	""	"True"
"character_trait_levels_colour_text_wh2_main_trait_black_ark_building_wh2_main_horde_def_slavery_3"	""	"True"
"character_trait_levels_explanation_text_wh2_main_trait_stance_astromancy"	"Spent multiple turns in Astromancy stance"	"True"
"character_trait_levels_removal_text_wh2_main_trait_wins_at_sea_2"	""	"True"
"character_trait_levels_removal_text_wh2_main_trait_wins_at_sea_3"	""	"True"
"character_trait_levels_removal_text_wh2_main_trait_wins_at_sea_1"	""	"True"
"character_trait_levels_colour_text_wh_main_trait_general_personality_vmp_black_arts_1"	"A student of the forbidden mysteries, yet not limited to a mortal span, so plenty of time to learn."	"True"
"character_trait_levels_removal_text_wh_main_trait_name_dummy_the_slaughterer"	""	"True"
"character_trait_levels_explanation_text_wh2_main_trait_casualties_1"	"Suffered high casualties in multiple battles"	"True"
"character_trait_levels_explanation_text_wh2_main_trait_casualties_2"	"Suffered high casualties in multiple battles"	"True"
"character_trait_levels_explanation_text_wh2_main_trait_casualties_3"	"Suffered high casualties in multiple battles"	"True"
"character_trait_levels_onscreen_name_wh_dlc07_trait_brt_lord_good_greenskins_1"	"Orcsbane"	"True"
"character_trait_levels_explanation_text_wh2_main_trait_public_order_2"	"Spent multiple turns in a settlement with low [[img:icon_public_order]][[/img]]\{\{tr:hp_campaign_public_order_term}}"	"True"
"character_trait_levels_explanation_text_wh2_main_trait_public_order_3"	"Spent multiple turns in a settlement with low [[img:icon_public_order]][[/img]]\{\{tr:hp_campaign_public_order_term}}"	"True"
"character_trait_levels_explanation_text_wh2_main_trait_public_order_1"	"Spent multiple turns in a settlement with low [[img:icon_public_order]][[/img]]\{\{tr:hp_campaign_public_order_term}}"	"True"
"character_trait_levels_explanation_text_wh2_main_trait_def_name_of_power_ca_10_the_dire_overseer"	""	"True"
"character_trait_levels_onscreen_name_wh_main_trait_name_dummy_the_slaughterer"	"."	"True"
"character_trait_levels_onscreen_name_wh2_main_trait_defeated_queen_headtaker"	"Verminflail"	"True"
"character_trait_levels_onscreen_name_wh2_main_trait_wins_at_sea_1"	"Good Sea Captain"	"True"
"character_trait_levels_onscreen_name_wh2_main_trait_wins_at_sea_3"	"Master & Commander"	"True"
"character_trait_levels_onscreen_name_wh2_main_trait_wins_at_sea_2"	"Superior Admiral"	"True"
"character_trait_levels_explanation_text_wh2_main_trait_corrupted_vampire"	"Present in a region with high [[img:icon_corruption_vmp]][[/img]]Vampiric corruption"	"True"
"character_trait_levels_removal_text_wh2_main_trait_attacking_defeat_1"	""	"True"
"character_trait_levels_removal_text_wh2_main_trait_attacking_defeat_2"	""	"True"
"character_trait_levels_removal_text_wh2_main_trait_attacking_defeat_3"	""	"True"
"character_trait_levels_onscreen_name_wh2_main_trait_defeated_teclis"	"Ruin Unrestrained"	"True"
"character_trait_levels_onscreen_name_wh2_main_trait_skv_boom_master"	"Boom Master"	"True"
"character_trait_levels_colour_text_wh_dlc07_trait_brt_lord_bad_sieging_1"	"Sieges are hard, this one has no idea."	"True"
"character_trait_levels_colour_text_wh_dlc07_trait_brt_lord_bad_sieging_3"	"Those walls look solid and tall."	"True"
"character_trait_levels_colour_text_wh_dlc07_trait_brt_lord_bad_sieging_2"	"How do you attack a wall\?"	"True"
"character_trait_levels_colour_text_wh2_main_trait_defeats_against_dark_elves"	"Friends and relatives killed by the Druchii were first made to suffer for the amusement of their cruel, heartless captors."	"True"
"character_trait_levels_colour_text_wh2_main_trait_defending_defeat_2"	"A poor defence means those walls will count for naught."	"True"
"character_trait_levels_colour_text_wh2_main_trait_defending_defeat_3"	"Known as "The fool on the wall" on the other side."	"True"
"character_trait_levels_colour_text_wh2_main_trait_skv_one_eye"	"Taking an eye is the best way to ensure the loyalty of an underling."	"True"
"character_trait_levels_colour_text_wh2_main_trait_defending_defeat_1"	"Which wall to place the soldiers on\? All of them maybe\?"	"True"
"character_trait_levels_onscreen_name_wh2_main_trait_agent_actions_against_wood_elves"	"Hates Wood Elves"	"True"
"character_trait_levels_explanation_text_wh2_main_trait_defeated_malagor_the_dark_omen"	"Defeated Malagor the Dark-Omen"	"True"
"character_trait_levels_explanation_text_wh2_main_trait_wins_against_rogue_armies"	"Achieved victory over rogue armies multiple times"	"True"
"character_trait_levels_explanation_text_wh2_main_trait_defeated_orion"	"Defeated Orion"	"True"
"character_trait_levels_onscreen_name_wh2_main_trait_routed_3"	"Craven"	"True"
"character_trait_levels_onscreen_name_wh2_main_trait_routed_2"	"Cowardly"	"True"
"character_trait_levels_onscreen_name_wh2_main_trait_routed_1"	"Fearful"	"True"
"character_trait_levels_colour_text_wh_dlc07_trait_brt_lord_good_far_from_capital_1"	""The Lady calls me hence. I must answer herâ€¦""	"True"
"character_trait_levels_explanation_text_wh2_main_trait_def_name_of_power_ar_12_grimgaze"	""	"True"
"character_trait_levels_colour_text_wh2_main_trait_black_ark_building_wh2_main_horde_def_bombardment_a_2"	""	"True"
"character_trait_levels_colour_text_wh2_main_trait_black_ark_building_wh2_main_horde_def_bombardment_b_2"	""	"True"
"character_trait_levels_colour_text_wh2_main_trait_black_ark_building_wh2_main_horde_def_bombardment_c_2"	""	"True"
"character_trait_levels_colour_text_wh2_main_trait_black_ark_building_wh2_main_horde_def_bombardment_a_1"	""	"True"
"character_trait_levels_colour_text_wh2_main_trait_black_ark_building_wh2_main_horde_def_bombardment_b_1"	""	"True"
"character_trait_levels_colour_text_wh2_main_trait_black_ark_building_wh2_main_horde_def_bombardment_c_1"	""	"True"
"character_trait_levels_explanation_text_wh_trait_dlc04_vlad_vanguard_not_shown"	""	"True"
"character_trait_levels_onscreen_name_wh_main_trait_name_dummy_de_bordeleaux"	""	"True"
"character_trait_levels_onscreen_name_wh2_main_trait_agent_target_success_1"	"Unlucky"	"True"
"character_trait_levels_onscreen_name_wh2_main_trait_agent_target_success_2"	"Hapless"	"True"
"character_trait_levels_onscreen_name_wh2_main_trait_agent_target_success_3"	"Cursed"	"True"
"character_trait_levels_removal_text_wh_dlc07_trait_brt_lord_bad_villain_1"	""	"True"
"character_trait_levels_removal_text_wh_dlc07_trait_brt_lord_bad_abducter_1"	""	"True"
"character_trait_levels_removal_text_wh_dlc07_trait_brt_lord_bad_attacker_1"	""	"True"
"character_trait_levels_removal_text_wh_dlc07_trait_brt_lord_bad_attacker_2"	""	"True"
"character_trait_levels_removal_text_wh_dlc07_trait_brt_lord_bad_attacker_3"	""	"True"
"character_trait_levels_onscreen_name_wh_dlc07_trait_brt_lord_good_victory_2"	"Hero"	"True"
"character_trait_levels_onscreen_name_wh_dlc07_trait_brt_lord_good_victory_3"	"Legend"	"True"
"character_trait_levels_onscreen_name_wh_dlc07_trait_brt_lord_good_victory_1"	"Warrior"	"True"
"character_trait_levels_colour_text_wh2_main_trait_black_ark_building_wh2_main_horde_def_worship_1"	""	"True"
"character_trait_levels_colour_text_wh2_main_trait_black_ark_building_wh2_main_horde_def_worship_2"	""	"True"
"character_trait_levels_removal_text_wh2_dlc09_trait_defeated_khatep"	""	"True"
"character_trait_levels_onscreen_name_wh2_dlc09_trait_defeated_arkhan"	"Arkhan the Blackened"	"True"
"character_trait_levels_onscreen_name_wh_dlc07_trait_brt_lord_good_vampires_1"	"Vampire Hunter"	"True"
"character_trait_levels_removal_text_wh2_main_trait_def_name_of_power_co_07_bloodscourge"	""	"True"
"character_trait_levels_colour_text_wh_dlc07_trait_brt_lord_good_defeated_grimgor_1"	"This hide is perhaps not as durable as it originally thoughtâ€¦"	"True"
"character_trait_levels_removal_text_wh2_main_trait_razing_2"	""	"True"
"character_trait_levels_removal_text_wh2_main_trait_razing_3"	""	"True"
"character_trait_levels_removal_text_wh_dlc07_trait_brt_lord_good_peasants_1"	""	"True"
"character_trait_levels_removal_text_wh2_main_trait_razing_1"	""	"True"
"character_trait_levels_explanation_text_wh_dlc06_trait_name_dummy_da_great_green_prophet"	""	"True"
"character_trait_levels_explanation_text_wh2_main_trait_stance_forced_march"	"Spent multiple turns in March stance"	"True"
"character_trait_levels_onscreen_name_wh_main_trait_name_dummy_grudgebearer"	"."	"True"
"character_trait_levels_onscreen_name_wh2_main_trait_def_name_of_power_co_03_poisonblade"	"Name of Power: "Poisonblade""	"True"
"character_trait_levels_explanation_text_wh2_main_trait_defeated_thorgrim_grudgebearer"	"Defeated Thorgrim Grudgebearer"	"True"
"character_trait_levels_colour_text_wh2_main_trait_agent_actions_against_greenskins"	"This one despises the Orcs and their foul kin, as all right-thinking beings should."	"True"
"character_trait_levels_removal_text_wh2_main_trait_stance_ambushing"	""	"True"
"character_trait_levels_removal_text_wh2_dlc09_trait_settra_title_start"	""	"True"
"character_trait_levels_onscreen_name_wh2_dlc09_trait_defeated_settra"	"Settra the Perishable"	"True"
"character_trait_levels_explanation_text_wh_dlc07_trait_brt_lord_bad_scared_of_greenskins_1"	"Gained by losing battles against Greenskin factions"	"True"
"character_trait_levels_explanation_text_wh2_main_trait_stance_recruiting"	"Spent multiple turns recruiting"	"True"
"character_trait_levels_removal_text_wh2_main_trait_def_name_of_power_ar_07_wrathbringer"	""	"True"
"character_trait_levels_colour_text_wh_main_trait_name_dummy_the_magnificent"	"."	"True"
"character_trait_levels_removal_text_wh_main_trait_name_dummy_the_everchosen"	""	"True"
"character_trait_levels_onscreen_name_wh2_main_trait_reinforcing_greenskins"	"Likes Greenskins"	"True"
"character_trait_levels_onscreen_name_wh2_main_trait_wins_against_lizardmen"	"Planbuster"	"True"
"character_trait_levels_explanation_text_wh2_main_trait_wins_1"	"Achieved victory in a very high percentage of battles"	"True"
"character_trait_levels_explanation_text_wh2_main_trait_wins_3"	"Achieved victory in a very high percentage of battles"	"True"
"character_trait_levels_explanation_text_wh2_main_trait_wins_2"	"Achieved victory in a very high percentage of battles"	"True"
"character_trait_levels_onscreen_name_wh2_dlc09_trait_spymaster"	"Secret Service"	"True"
"character_trait_levels_removal_text_wh2_main_trait_agent_actions_against_dark_elves"	""	"True"
"character_trait_levels_colour_text_wh2_main_trait_agent_action_steal_technology"	"\{\{tr:agent_action_steal_technology_description}}"	"True"
"character_trait_levels_removal_text_wh2_main_trait_black_ark_building_wh2_main_horde_def_settlement_5"	""	"True"
"character_trait_levels_removal_text_wh2_main_trait_black_ark_building_wh2_main_horde_def_settlement_4"	""	"True"
"character_trait_levels_removal_text_wh2_main_trait_black_ark_building_wh2_main_horde_def_settlement_3"	""	"True"
"character_trait_levels_removal_text_wh2_main_trait_black_ark_building_wh2_main_horde_def_settlement_2"	""	"True"
"character_trait_levels_colour_text_wh2_main_trait_defeated_ungrim_ironfist"	"Although the Slayer King has been toppled, no doubt he'll be back, bearing the Axe of Dargo and a serious grudge!"	"True"
"character_trait_levels_colour_text_wh2_main_trait_pacifist_1"	"Many people dislike war - they are the ones cowering in their beds."	"True"
"character_trait_levels_colour_text_wh2_main_trait_pacifist_3"	"A pacifist\? You have come to the wrong world."	"True"
"character_trait_levels_colour_text_wh2_main_trait_pacifist_2"	"If you appease an opponent, he will always ask for more."	"True"
"character_trait_levels_removal_text_wh2_main_trait_agent_actions_against_lizardmen"	""	"True"
"character_trait_levels_colour_text_wh_main_trait_name_dummy_kemmler"	"."	"True"
"character_trait_levels_onscreen_name_wh2_main_trait_wins_against_vampires"	"Vampire Hunter"	"True"
"character_trait_levels_onscreen_name_wh_main_trait_name_dummy_gelt"	"."	"True"
"character_trait_levels_colour_text_wh2_main_trait_wins_against_humans"	""Kill them. Kill them all. Their fake gods will recognise their own, if indeed they exist.""	"True"
"character_trait_levels_explanation_text_wh2_main_trait_defeated_malekith"	"Defeated Malekith"	"True"
"character_trait_levels_colour_text_wh2_main_trait_defeated_khazrak_one_eye"	"His single eye will not avail the Lord of Beasts a victory, nor all the fury in his twisted heart."	"True"
"character_trait_levels_removal_text_wh2_main_trait_wins_against_vampires"	""	"True"
"character_trait_levels_colour_text_wh2_main_trait_far_from_capital"	"To the very edge of the world would this one go, so great is their thirst for adventure, their lust for battle."	"True"
"character_trait_levels_onscreen_name_wh_dlc07_trait_brt_lord_good_attacker_1"	"Confident Attacker"	"True"
"character_trait_levels_onscreen_name_wh_dlc07_trait_brt_lord_good_attacker_2"	"Good Attacker"	"True"
"character_trait_levels_onscreen_name_wh_dlc07_trait_brt_lord_good_attacker_3"	"Superior Attacker"	"True"
"character_trait_levels_onscreen_name_wh_main_trait_name_dummy_franz"	"."	"True"
"character_trait_levels_colour_text_wh2_main_trait_defeated_vlad_von_carstein"	"Down but probably not out, as you cannot really kill what doesn't truly live."	"True"
"character_trait_levels_removal_text_wh2_main_trait_black_ark_building_wh2_main_horde_def_military_2"	""	"True"
"character_trait_levels_removal_text_wh2_main_trait_black_ark_building_wh2_main_horde_def_military_3"	""	"True"
"character_trait_levels_removal_text_wh2_main_trait_black_ark_building_wh2_main_horde_def_military_1"	""	"True"
"character_trait_levels_onscreen_name_wh_main_trait_name_dummy_blank"	""	"True"
"character_trait_levels_removal_text_wh2_main_trait_defeated_louen_leoncouer"	""	"True"
"character_trait_levels_onscreen_name_wh2_main_trait_agent_actions_against_high_elves"	"Hates High Elves"	"True"
"character_trait_levels_explanation_text_wh_main_trait_all_personality_all_hates_greenskins_1"	""	"True"
"character_trait_levels_colour_text_wh2_main_trait_agent_action_assault_garrison"	"\{\{tr:agent_action_assault_garrison_description}}"	"True"
"character_trait_levels_onscreen_name_wh_dlc07_trait_brt_lord_good_knightly_1"	"Nobleman"	"True"
"character_trait_levels_removal_text_wh_dlc06_clan_angrund_ancestor_thane_1"	""	"True"
"character_trait_levels_colour_text_wh2_main_trait_agent_action_assassinate"	"\{\{tr:agent_action_assassinate_description}}"	"True"
"character_trait_levels_removal_text_wh_dlc03_trait_name_dummy_the_one_eye"	""	"True"
"character_trait_levels_removal_text_wh_dlc07_trait_brt_lord_good_defender_2"	""	"True"
"character_trait_levels_removal_text_wh_dlc07_trait_brt_lord_good_defender_3"	""	"True"
"character_trait_levels_removal_text_wh_dlc07_trait_brt_lord_good_defender_1"	""	"True"
"character_trait_levels_explanation_text_wh_dlc07_trait_brt_lord_bad_scared_of_beastmen_1"	"Gained by losing battles against Beastmen factions"	"True"
"character_trait_levels_onscreen_name_wh2_main_trait_ruler_personality_kroq_gar_ancient_spawn"	"Ancient Spawn"	"True"
"character_trait_levels_removal_text_wh2_main_trait_stance_tunneling"	""	"True"
"character_trait_levels_explanation_text_wh2_main_trait_defeated_isabella_von_carstein"	"Defeated Isabella von Carstein"	"True"
"character_trait_levels_removal_text_wh2_main_trait_def_name_of_power_co_08_griefbringer"	""	"True"
"character_trait_levels_colour_text_wh_main_trait_supreme_patriarch"	"The Supreme Patriarch is master of all the Colleges of Magic, his word is law in all matters magical."	"True"
"character_trait_levels_removal_text_wh2_main_trait_wins_against_dark_elves"	""	"True"
"character_trait_levels_onscreen_name_wh2_main_trait_stance_raiding"	"Raider"	"True"
"character_trait_levels_onscreen_name_wh2_main_trait_def_name_of_power_co_10_fatedshield"	"Name of Power: "Fatedshield""	"True"
"character_trait_levels_colour_text_wh2_main_trait_reinforcing"	"The legends tell of heroes riding to an eleventh-hour salvation. The legends are real."	"True"
"character_trait_levels_colour_text_wh2_main_trait_wins_against_dwarfs"	""Nice, more beards for my collection. I will sleep softly this night.""	"True"
"character_trait_levels_onscreen_name_wh_dlc06_clan_angrund_ancestor_thane_other_1"	"Clan Angrund Ancestor"	"True"
"character_trait_levels_colour_text_wh_main_trait_dummy_title_emperor"	"."	"True"
"character_trait_levels_onscreen_name_wh2_main_trait_defeats_against_skaven"	"Fears Skaven"	"True"
"character_trait_levels_removal_text_wh_dlc06_clan_angrund_ancestor_thane_other_1"	""	"True"
"character_trait_levels_removal_text_wh2_main_trait_defeats_against_wood_elves"	""	"True"
"character_trait_levels_explanation_text_wh2_main_trait_siege_defeat_3"	"Suffered defeat in multiple siege battles"	"True"
"character_trait_levels_explanation_text_wh2_main_trait_siege_defeat_2"	"Suffered defeat in multiple siege battles"	"True"
"character_trait_levels_explanation_text_wh2_main_trait_siege_defeat_1"	"Suffered defeat in multiple siege battles"	"True"
"character_trait_levels_colour_text_wh2_main_trait_agent_target_fail_1"	"Fortune favours the boldâ€¦ or is it the foolish\?"	"True"
"character_trait_levels_colour_text_wh2_main_trait_agent_target_fail_3"	"There are gods who smile upon the chancers, gamblers and risk-takers of the world. This one is blessed by them."	"True"
"character_trait_levels_colour_text_wh2_main_trait_agent_target_fail_2"	"Finally made some armour saves did you\?"	"True"
"character_trait_levels_onscreen_name_wh2_main_trait_def_name_of_power_ar_10_the_grey_vanquisher"	"Name of Power: "the Grey Vanquisher""	"True"
"character_trait_levels_colour_text_wh_dlc06_wurrzag_anti_trait_1"	"[HIDDEN]"	"True"
"character_trait_levels_onscreen_name_wh_dlc07_trait_brt_lord_good_farming_1"	"Agriculturalist"	"True"
"character_trait_levels_removal_text_wh_dlc07_trait_brt_lord_bad_scared_of_chaos_1"	""	"True"
"character_trait_levels_explanation_text_wh2_main_trait_lone_wolf_1"	"Spent consecutive turns in enemy regions"	"True"
"character_trait_levels_explanation_text_wh2_main_trait_lone_wolf_3"	"Spent consecutive turns in enemy regions"	"True"
"character_trait_levels_explanation_text_wh2_main_trait_lone_wolf_2"	"Spent consecutive turns in enemy regions"	"True"
"character_trait_levels_colour_text_wh_main_trait_name_dummy_leoncoeur"	","	"True"
"character_trait_levels_explanation_text_wh2_main_trait_reinforcing_high_elves"	"Reinforced High Elf armies in battle multiple times"	"True"
"character_trait_levels_removal_text_wh2_main_trait_post_battle_ransom"	""	"True"
"character_trait_levels_removal_text_wh2_dlc09_trait_defeated_tretch"	""	"True"
"character_trait_levels_colour_text_wh2_main_trait_wins_at_sea_2"	""Stromfel can try to land us on those rocks, but He'll fail!""	"True"
"character_trait_levels_colour_text_wh2_main_trait_wins_at_sea_3"	""I'd rather have the crew three sheets to the wind than face a mutiny. Lads! It's grog o'clock!""	"True"
"character_trait_levels_colour_text_wh_dlc07_trait_brt_lord_good_defeated_khazrak_1"	"His single eye will not avail the Lord of Beasts a victory; nor all the fury in his twisted heart."	"True"
"character_trait_levels_colour_text_wh2_main_trait_wins_at_sea_1"	"He knows more than larboard and starboard."	"True"
"character_trait_levels_colour_text_wh_main_trait_name_dummy_the_slaughterer"	"."	"True"
"character_trait_levels_onscreen_name_wh2_main_trait_defeated_alberic_de_bordeleaux"	"Hammer & Anvil"	"True"
"character_trait_levels_removal_text_wh2_main_trait_pacifist_1"	""	"True"
"character_trait_levels_removal_text_wh2_main_trait_pacifist_3"	""	"True"
"character_trait_levels_removal_text_wh2_main_trait_pacifist_2"	""	"True"
"character_trait_levels_removal_text_wh2_main_trait_agent_action_block_army"	""	"True"
"character_trait_levels_colour_text_wh2_main_trait_black_ark_building_wh2_main_horde_def_settlement_3"	""	"True"
"character_trait_levels_colour_text_wh2_main_trait_black_ark_building_wh2_main_horde_def_settlement_2"	""	"True"
"character_trait_levels_colour_text_wh2_main_trait_black_ark_building_wh2_main_horde_def_settlement_5"	""	"True"
"character_trait_levels_colour_text_wh2_main_trait_black_ark_building_wh2_main_horde_def_settlement_4"	""	"True"
"character_trait_levels_colour_text_wh_dlc03_trait_name_dummy_the_dark_omen"	""	"True"
"character_trait_levels_explanation_text_wh2_main_trait_def_name_of_power_ca_02_darkpath"	""	"True"
"character_trait_levels_removal_text_wh2_main_trait_wins_against_high_elves"	""	"True"
"character_trait_levels_colour_text_wh2_main_trait_defeats_at_sea_2"	"He's no captain, he spends more time throwing up over the stern than orderin' the crew."	"True"
"character_trait_levels_colour_text_wh2_main_trait_defeats_at_sea_3"	"A captain should appear on deck, not hide, whimpering, in his cabin."	"True"
"character_trait_levels_colour_text_wh2_main_trait_defeats_at_sea_1"	"Fear of the ocean is valid concern, especially when on the Sea of Claws."	"True"
"character_trait_levels_onscreen_name_wh2_main_trait_def_name_of_power_ca_01_dreadtongue"	"Name of Power: "Dreadtongue""	"True"
"character_trait_levels_removal_text_wh_dlc07_trait_brt_lord_bad_renegade_1"	""	"True"
"character_trait_levels_explanation_text_wh2_main_trait_defeated_grimgor_ironhide"	"Defeated Grimgor Ironhide"	"True"
"character_trait_levels_onscreen_name_wh2_dlc09_trait_defeated_tretch"	"Craven by Name..."	"True"
"character_trait_levels_colour_text_wh2_main_trait_attacking_victory_1"	"Confidence - the key to a successful battlefield action."	"True"
"character_trait_levels_colour_text_wh2_main_trait_attacking_victory_2"	"A good attack requires skilled warriors and superior numbers."	"True"
"character_trait_levels_colour_text_wh2_main_trait_attacking_victory_3"	"Superior generalship and battlefield acumen is needed in war."	"True"
"character_trait_levels_onscreen_name_wh_dlc07_trait_brt_lord_good_defender_2"	"Good Defender"	"True"
"character_trait_levels_onscreen_name_wh_dlc07_trait_brt_lord_good_defender_3"	"Superior Defender"	"True"
"character_trait_levels_onscreen_name_wh_dlc07_trait_brt_lord_good_defender_1"	"Confident Defender"	"True"
"character_trait_levels_removal_text_wh2_main_trait_black_ark_building_wh2_main_horde_def_bombardment_a_2"	""	"True"
"character_trait_levels_removal_text_wh2_main_trait_black_ark_building_wh2_main_horde_def_bombardment_b_2"	""	"True"
"character_trait_levels_removal_text_wh2_main_trait_black_ark_building_wh2_main_horde_def_bombardment_c_2"	""	"True"
"character_trait_levels_removal_text_wh2_main_trait_black_ark_building_wh2_main_horde_def_bombardment_a_1"	""	"True"
"character_trait_levels_removal_text_wh2_main_trait_black_ark_building_wh2_main_horde_def_bombardment_b_1"	""	"True"
"character_trait_levels_removal_text_wh2_main_trait_black_ark_building_wh2_main_horde_def_bombardment_c_1"	""	"True"
"character_trait_levels_removal_text_wh2_main_trait_ruler_personality_kroq_gar_ancient_spawn"	""	"True"
"character_trait_levels_onscreen_name_wh2_main_trait_stance_tunneling"	"Pathfinder"	"True"
"character_trait_levels_explanation_text_wh2_main_trait_ruler_personality_tyrion_no_politician"	""	"True"
"character_trait_levels_removal_text_wh2_main_trait_defeated_vlad_von_carstein"	""	"True"
"character_trait_levels_onscreen_name_wh2_main_trait_black_ark_building_wh2_main_horde_def_bombardment_a_1"	""	"True"
"character_trait_levels_onscreen_name_wh2_main_trait_black_ark_building_wh2_main_horde_def_bombardment_b_1"	""	"True"
"character_trait_levels_onscreen_name_wh2_main_trait_black_ark_building_wh2_main_horde_def_bombardment_c_1"	""	"True"
"character_trait_levels_onscreen_name_wh2_main_trait_black_ark_building_wh2_main_horde_def_bombardment_a_2"	""	"True"
"character_trait_levels_onscreen_name_wh2_main_trait_black_ark_building_wh2_main_horde_def_bombardment_b_2"	""	"True"
"character_trait_levels_onscreen_name_wh2_main_trait_black_ark_building_wh2_main_horde_def_bombardment_c_2"	""	"True"
"character_trait_levels_onscreen_name_wh2_main_trait_def_name_of_power_co_08_griefbringer"	"Name of Power: "Griefbringer""	"True"
"character_trait_levels_explanation_text_wh2_main_trait_defeated_karl_franz"	"Defeated Karl Franz"	"True"
"character_trait_levels_colour_text_wh2_main_trait_defeated_wurzzag"	"When you take a swing at Da Prophet, you smite Gork (and Mork) as well!"	"True"
"character_trait_levels_explanation_text_wh2_dlc09_trait_defeated_settra_as_surtha"	"Surtha Ek defeated Settra the Imperishable"	"True"
"character_trait_levels_explanation_text_wh2_main_trait_defeated_volkmar_the_grim"	"Defeated Volkmar the Grim"	"True"
"character_trait_levels_explanation_text_wh2_main_trait_defeated_helmen_ghorst"	"Defeated Helman Ghorst"	"True"
"character_trait_levels_explanation_text_wh2_main_trait_reinforcing_dark_elves"	"Reinforced Dark Elf armies in battle multiple times"	"True"
"character_trait_levels_removal_text_wh_dlc07_trait_brt_lord_good_attacker_1"	""	"True"
"character_trait_levels_removal_text_wh_dlc07_trait_brt_lord_good_attacker_2"	""	"True"
"character_trait_levels_removal_text_wh_dlc07_trait_brt_lord_good_attacker_3"	""	"True"
"character_trait_levels_onscreen_name_wh2_main_trait_ruler_personality_malekith_witch_king"	"Witch King of Naggaroth"	"True"
"character_trait_levels_onscreen_name_wh2_main_trait_defeated_durthu"	"Tree Surgeon"	"True"
"character_trait_levels_onscreen_name_wh2_main_trait_slaver"	"Slaver"	"True"
"character_trait_levels_onscreen_name_wh2_main_trait_defeats_against_chaos"	"Fears Chaos"	"True"
"character_trait_levels_onscreen_name_wh2_main_trait_def_name_of_power_ca_12_the_tormentor"	"Name of Power: "the Tormentor""	"True"
"character_trait_levels_onscreen_name_wh2_main_trait_black_ark_building_wh2_main_horde_def_military_2"	""	"True"
"character_trait_levels_onscreen_name_wh2_main_trait_black_ark_building_wh2_main_horde_def_military_3"	""	"True"
"character_trait_levels_onscreen_name_wh2_main_trait_black_ark_building_wh2_main_horde_def_military_1"	""	"True"
"character_trait_levels_colour_text_wh2_main_trait_corrupted_skaven"	""Ratmen\? Surely you jest\? There's no such thing!""	"True"
"character_trait_levels_colour_text_wh_main_trait_general_personality_vmp_summon_creatures_1"	"Only the direst of all Undead creatures will come to this summons."	"True"
"character_trait_levels_colour_text_wh2_main_trait_post_battle_execute"	"Cut off an enemy's head and you kill the body too. So it is with leaders and their armies."	"True"
"character_trait_levels_removal_text_wh2_main_trait_ruler_personality_malekith_witch_king"	""	"True"
"character_trait_levels_onscreen_name_wh2_main_trait_defeated_louen_leoncouer"	"Kingslayer"	"True"
"character_trait_levels_removal_text_wh2_main_trait_agent_actions_against_high_elves"	""	"True"
"character_trait_levels_colour_text_wh_dlc03_trait_name_dummy_the_one_eye"	""	"True"
"character_trait_levels_onscreen_name_wh2_main_trait_siege_victory_1"	"Sapper"	"True"
"character_trait_levels_onscreen_name_wh2_main_trait_siege_victory_2"	"Confident Besieger"	"True"
"character_trait_levels_onscreen_name_wh2_main_trait_siege_victory_3"	"Siege Expert"	"True"
"character_trait_levels_explanation_text_wh2_main_trait_def_name_of_power_ca_09_the_dark_marshall"	""	"True"
"character_trait_levels_removal_text_wh2_main_trait_defeats_against_chaos"	""	"True"
"character_trait_levels_removal_text_wh2_main_trait_def_name_of_power_ca_12_the_tormentor"	""	"True"
"character_trait_levels_removal_text_wh_dlc07_trait_brt_lord_good_knightly_1"	""	"True"
"character_trait_levels_onscreen_name_wh2_main_trait_wins_against_beastmen"	"Beast Tamer"	"True"
"character_trait_levels_colour_text_wh2_main_trait_defeated_fay_enchantress"	"At this rate, the Lady of the Lake is going to have to find another representativeâ€¦"	"True"
"character_trait_levels_explanation_text_wh_dlc07_trait_brt_lord_bad_scared_of_vampires_1"	"Gained by losing battles against Undead factions"	"True"
"character_trait_levels_explanation_text_wh_dlc07_trait_brt_lord_bad_lazy_1"	"Gained by spending multiple turns in a settlement you control"	"True"
"character_trait_levels_explanation_text_wh_dlc07_trait_brt_lord_bad_lazy_2"	"Gained by spending multiple turns in a region you control"	"True"
"character_trait_levels_onscreen_name_wh_dlc07_trait_brt_lord_good_sieging_1"	"Siege Expert"	"True"
"character_trait_levels_onscreen_name_wh_dlc07_trait_brt_lord_good_sieging_3"	"Into the Breach!"	"True"
"character_trait_levels_onscreen_name_wh_dlc07_trait_brt_lord_good_sieging_2"	"Sapper"	"True"
"character_trait_levels_removal_text_wh2_main_trait_wins_against_beastmen"	""	"True"
"character_trait_levels_explanation_text_wh2_main_trait_defeated_mannfred_von_carstein"	"Defeated Mannfred von Carstein"	"True"
"character_trait_levels_colour_text_wh2_main_trait_skv_musk_of_the_overlord"	"No-one dares question the one bearing their overlord's scent!"	"True"
"character_trait_levels_onscreen_name_wh2_main_trait_def_name_of_power_ar_07_wrathbringer"	"Name of Power: "Wrathbringer""	"True"
"character_trait_levels_onscreen_name_wh_main_trait_name_dummy_the_everchosen"	"."	"True"
"character_trait_levels_removal_text_wh2_main_trait_black_ark_building_wh2_main_horde_def_entertainment_2"	""	"True"
"character_trait_levels_removal_text_wh2_main_trait_black_ark_building_wh2_main_horde_def_entertainment_3"	""	"True"
"character_trait_levels_removal_text_wh2_main_trait_black_ark_building_wh2_main_horde_def_entertainment_1"	""	"True"
"character_trait_levels_colour_text_wh2_main_trait_defeats_against_wood_elves"	"This one has seen comrades coldly sacrificed to the forest and the whims of its aloof guardians, and has vowed never to return."	"True"
"character_trait_levels_onscreen_name_wh2_main_trait_agent_actions_against_dark_elves"	"Hates Dark Elves"	"True"
"character_trait_levels_removal_text_wh_main_trait_dummy_title_emperor"	""	"True"
"character_trait_levels_explanation_text_wh_dlc06_clan_angrund_ancestor_runesmith_1"	""	"True"
"character_trait_levels_colour_text_wh_main_trait_all_personality_all_hates_dwarfs_1"	"The Dwarfs cling to the mountain roots like parasites - they should be purged!"	"True"
"character_trait_levels_colour_text_wh2_main_trait_black_ark_building_wh2_main_horde_def_sorcery_1"	""	"True"
"character_trait_levels_colour_text_wh2_main_trait_black_ark_building_wh2_main_horde_def_sorcery_2"	""	"True"
"character_trait_levels_onscreen_name_wh2_main_trait_black_ark_building_wh2_main_horde_def_entertainment_1"	""	"True"
"character_trait_levels_onscreen_name_wh2_main_trait_black_ark_building_wh2_main_horde_def_entertainment_3"	""	"True"
"character_trait_levels_onscreen_name_wh2_main_trait_black_ark_building_wh2_main_horde_def_entertainment_2"	""	"True"
"character_trait_levels_colour_text_wh_dlc07_trait_brt_lord_bad_scared_of_chaos_1"	""Ruin has been visited upon us; dark and unreadable. I fear we shall never be the sameâ€¦""	"True"
"character_trait_levels_colour_text_wh2_main_trait_post_battle_ransom"	"You, my sweet, will fetch a pretty price. Yes indeedâ€¦"	"True"
"character_trait_levels_onscreen_name_wh2_main_trait_stance_stalking"	"Stalker"	"True"
"character_trait_levels_explanation_text_wh_trait_dlc04_helman_not_shown"	""	"True"
"character_trait_levels_removal_text_wh_dlc06_wurrzag_anti_trait_1"	""	"True"
"character_trait_levels_explanation_text_wh2_main_trait_defeats_against_high_elves"	"Defeated by High Elves"	"True"
"character_trait_levels_colour_text_wh2_main_trait_defeated_heinrich_kemmler"	"Kemmler's quest for the darkest of knowledge will never be over, but has suffered something of a setback."	"True"
"character_trait_levels_removal_text_wh_dlc07_trait_brt_lord_bad_lazy_2"	""	"True"
"character_trait_levels_removal_text_wh_dlc07_trait_brt_lord_bad_lazy_1"	""	"True"
"character_trait_levels_explanation_text_wh_dlc07_trait_brt_lord_bad_sacking_1"	"Gained by sacking settlements"	"True"
"character_trait_levels_explanation_text_wh_dlc07_trait_brt_lord_bad_sacking_2"	"Gained by sacking settlements"	"True"
"character_trait_levels_explanation_text_wh_dlc07_trait_brt_lord_bad_sacking_3"	"Gained by sacking settlements"	"True"
"character_trait_levels_colour_text_wh2_main_trait_black_ark_building_wh2_main_horde_def_beasts_1"	""	"True"
"character_trait_levels_colour_text_wh2_main_trait_black_ark_building_wh2_main_horde_def_beasts_3"	""	"True"
"character_trait_levels_colour_text_wh2_main_trait_black_ark_building_wh2_main_horde_def_beasts_2"	""	"True"
"character_trait_levels_removal_text_wh2_main_trait_reinforcing_wood_elves"	""	"True"
"character_trait_levels_removal_text_wh_trait_dlc04_helman_not_shown"	""	"True"
"character_trait_levels_explanation_text_wh_dlc06_clan_angrund_ancestor_thane_other_1"	""	"True"
"character_trait_levels_onscreen_name_wh2_main_trait_reinforcing_skaven"	"Likes Skaven"	"True"
"character_trait_levels_onscreen_name_wh_main_trait_name_dummy_ironfist"	"."	"True"
"character_trait_levels_onscreen_name_wh2_main_trait_wins_against_humans"	"Man's Ruin"	"True"
"character_trait_levels_colour_text_wh_main_trait_name_dummy_franz"	"."	"True"
"character_trait_levels_colour_text_wh_main_trait_name_dummy_blank"	""	"True"
"character_trait_levels_colour_text_wh2_main_trait_defeated_skarsnik"	"Sometimes, even the sneakiest among us come unstuck."	"True"
"character_trait_levels_explanation_text_wh_dlc07_trait_brt_lord_bad_traitor_1"	"Gained by fighting King Louen Leoncoeur"	"True"
"character_trait_levels_explanation_text_wh2_main_trait_agent_actions_against_high_elves"	"Carried out successful [[img:icon_hero]][[/img]]Hero actions against High Elves"	"True"
"character_trait_levels_removal_text_wh2_main_trait_lazy_1"	""	"True"
"character_trait_levels_removal_text_wh2_main_trait_lazy_2"	""	"True"
"character_trait_levels_removal_text_wh2_main_trait_lazy_3"	""	"True"
"character_trait_levels_explanation_text_wh_dlc07_trait_brt_lord_good_attacker_3"	"Gained by winning offensive battles"	"True"
"character_trait_levels_explanation_text_wh_dlc07_trait_brt_lord_good_attacker_2"	"Gained by winning offensive battles"	"True"
"character_trait_levels_explanation_text_wh_dlc07_trait_brt_lord_good_attacker_1"	"Gained by winning offensive battles"	"True"
"character_trait_levels_removal_text_wh2_main_trait_defeated_azhag_the_slaughterer"	""	"True"
"character_trait_levels_colour_text_wh2_main_trait_defeats_against_lizardmen"	"The sweltering heat, suspiciously clammy skin, and the cold, blank stares that stretch off into eternity are just too much for someâ€¦"	"True"
"character_trait_levels_removal_text_wh_dlc06_clan_angrund_ancestor_runesmith_1"	""	"True"
"character_trait_levels_removal_text_wh_dlc07_trait_brt_lord_bad_scared_of_beastmen_1"	""	"True"
"character_trait_levels_onscreen_name_wh_dlc07_trait_brt_lord_bad_scared_of_beastmen_1"	"Beastfear"	"True"
"character_trait_levels_explanation_text_wh_dlc07_trait_brt_lord_good_knightly_1"	"Gained by maintaining an army consisting mainly of Knights"	"True"
"character_trait_levels_removal_text_wh2_main_trait_defeated_orion"	""	"True"
"character_trait_levels_colour_text_wh2_main_trait_agent_action_damage_building"	"\{\{tr:agent_action_damage_building_description}}"	"True"
"character_trait_levels_explanation_text_wh2_main_trait_ruler_personality_kroq_gar_ancient_spawn"	""	"True"
"character_trait_levels_onscreen_name_wh2_main_trait_def_name_of_power_co_12_hydrablood"	"Name of Power: "Hydrablood""	"True"
"character_trait_levels_removal_text_wh2_main_trait_defeated_malagor_the_dark_omen"	""	"True"
"character_trait_levels_colour_text_wh2_main_trait_defeated_kroq_gar"	"Today, the battle is over for Xhotl's last defender, but the war rages on - have no doubt."	"True"
"character_trait_levels_explanation_text_wh_dlc07_trait_brt_lord_bad_renegade_1"	"Gained by fighting Empire factions"	"True"
"character_trait_levels_explanation_text_wh2_main_trait_wins_against_high_elves"	"Achieved victory over High Elves multiple times"	"True"
"character_trait_levels_onscreen_name_wh2_main_trait_ruler_personality_tiranoc_chariots"	"Chariot Master"	"True"
"character_trait_levels_explanation_text_wh2_main_trait_attacking_defeat_1"	"Suffered defeat in multiple offensive battles"	"True"
"character_trait_levels_explanation_text_wh2_main_trait_attacking_defeat_3"	"Suffered defeat in multiple offensive battles"	"True"
"character_trait_levels_explanation_text_wh2_main_trait_attacking_defeat_2"	"Suffered defeat in multiple offensive battles"	"True"
"character_trait_levels_colour_text_wh2_main_trait_def_name_of_power_co_10_fatedshield"	""	"True"
"character_trait_levels_removal_text_wh_main_trait_all_personality_all_hates_greenskins_1"	""	"True"
"character_trait_levels_onscreen_name_wh2_main_trait_def_name_of_power_co_01_blackstone"	"Name of Power: "Blackstone""	"True"
"character_trait_levels_onscreen_name_wh_main_trait_all_personality_all_hates_greenskins_1"	"Hates Greenskins"	"True"
"character_trait_levels_explanation_text_wh2_main_trait_agent_action_block_army"	"Carried out successful [[img:icon_hero]][[/img]]Hero actions"	"True"
"character_trait_levels_removal_text_wh2_main_trait_public_order_3"	""	"True"
"character_trait_levels_removal_text_wh2_main_trait_public_order_2"	""	"True"
"character_trait_levels_removal_text_wh2_main_trait_public_order_1"	""	"True"
"character_trait_levels_onscreen_name_wh2_main_trait_reinforcing"	"Saviour"	"True"
"character_trait_levels_onscreen_name_wh2_main_trait_wins_against_dwarfs"	"Beard Collector"	"True"
"character_trait_levels_colour_text_wh2_main_trait_agent_action_assault_unit"	"\{\{tr:agent_action_assault_unit_description}}"	"True"
"character_trait_levels_colour_text_wh2_main_trait_stance_channeling"	"You do not have to don robes to be a zealot."	"True"
"character_trait_levels_explanation_text_wh2_main_trait_wins_against_vampires"	"Achieved victory over Vampire Counts multiple times"	"True"
"character_trait_levels_removal_text_wh2_main_trait_defeated_thorgrim_grudgebearer"	""	"True"
"character_trait_levels_onscreen_name_wh2_main_trait_def_name_of_power_co_05_spiteheart"	"Name of Power: "Spiteheart""	"True"
"character_trait_levels_removal_text_wh2_main_trait_defeated_malekith"	""	"True"
"character_trait_levels_colour_text_wh2_dlc09_trait_defeated_surtha_as_settra"	"And so a mighty Chaos warlord lies defeated, beyond the help of the Dark Gods he serves."	"True"
"character_trait_levels_onscreen_name_wh2_main_trait_defeated_malekith"	"Immortal Unbeloved"	"True"
"character_trait_levels_removal_text_wh2_main_trait_defeated_karl_franz"	""	"True"
"character_trait_levels_colour_text_wh2_main_trait_def_name_of_power_ar_10_the_grey_vanquisher"	""	"True"
"character_trait_levels_colour_text_wh_dlc06_clan_angrund_ancestor_master_engineer_1"	"Sheer weight of numbers forced us back, against our best efforts to remain stalwart. That will not happen again. I vow it."	"True"
"character_trait_levels_explanation_text_wh_dlc07_trait_brt_lord_bad_villain_1"	"Gained by fighting Bretonnian factions"	"True"
"character_trait_levels_onscreen_name_wh2_main_trait_agent_target_fail_1"	"Fortunate"	"True"
"character_trait_levels_onscreen_name_wh2_main_trait_agent_target_fail_3"	"Blessed"	"True"
"character_trait_levels_onscreen_name_wh2_main_trait_agent_target_fail_2"	"Lucky"	"True"
"character_trait_levels_onscreen_name_wh_main_trait_name_dummy_leoncoeur"	","	"True"
"character_trait_levels_onscreen_name_wh2_main_trait_defeats_against_greenskins"	"Fears Greenskins"	"True"
"character_trait_levels_colour_text_wh_dlc07_trait_brt_lord_good_farming_1"	"A prosperous nation is built on the fields of the farm, not a workshop floor."	"True"
"character_trait_levels_removal_text_wh2_main_trait_def_name_of_power_ca_02_darkpath"	""	"True"
"character_trait_levels_removal_text_wh2_main_trait_black_ark_building_wh2_main_horde_def_beasts_1"	""	"True"
"character_trait_levels_removal_text_wh2_main_trait_black_ark_building_wh2_main_horde_def_beasts_3"	""	"True"
"character_trait_levels_removal_text_wh2_main_trait_black_ark_building_wh2_main_horde_def_beasts_2"	""	"True"
"character_trait_levels_colour_text_wh2_main_trait_stance_astromancy"	"The movement of the stars and planets interests this one greatly."	"True"
"character_trait_levels_explanation_text_wh2_main_trait_agent_action_wound"	"Carried out successful [[img:icon_hero]][[/img]]Hero actions"	"True"
"character_trait_levels_explanation_text_wh2_main_trait_wins_against_dark_elves"	"Achieved victory over Dark Elves multiple times"	"True"
"character_trait_levels_colour_text_wh2_main_trait_exploring"	"By prevailing over all obstacles and distractions, one may unfailingly arrive at their chosen goal or destination."	"True"
"character_trait_levels_explanation_text_wh2_dlc09_trait_defeated_tretch"	"Defeated Tretch Craventail"	"True"
"character_trait_levels_colour_text_wh2_main_trait_def_name_of_power_ca_01_dreadtongue"	""	"True"
"character_trait_levels_explanation_text_wh2_main_trait_black_ark_building_wh2_main_horde_def_entertainment_3"	""	"True"
"character_trait_levels_explanation_text_wh2_main_trait_black_ark_building_wh2_main_horde_def_entertainment_2"	""	"True"
"character_trait_levels_explanation_text_wh2_main_trait_black_ark_building_wh2_main_horde_def_entertainment_1"	""	"True"
"character_trait_levels_colour_text_wh2_main_trait_reinforcing_wood_elves"	""It's not personal, you see\? The forest is their only concern. I can understand that - it is very beautiful after all.""	"True"
"character_trait_levels_onscreen_name_wh2_main_trait_def_name_of_power_ca_02_darkpath"	"Name of Power: "Darkpath""	"True"
"character_trait_levels_explanation_text_wh2_main_trait_wins_against_beastmen"	"Achieved victory over Beastmen multiple times"	"True"
"character_trait_levels_colour_text_wh2_main_trait_lazy_1"	"Thinking about something is not the same as doing it."	"True"
"character_trait_levels_colour_text_wh2_main_trait_lazy_2"	""Why should I stir\? Do my followers not work in my stead\?""	"True"
"character_trait_levels_colour_text_wh2_main_trait_lazy_3"	"Nurgle would bless the indolence if it didn't breed such incompetence!"	"True"
"character_trait_levels_colour_text_wh2_main_trait_agent_actions_against_dwarfs"	"The Dwarfs cling to the mountain roots like parasites - this one will purge them!"	"True"
"character_trait_levels_removal_text_wh2_main_trait_lone_wolf_3"	""	"True"
"character_trait_levels_removal_text_wh2_main_trait_lone_wolf_2"	""	"True"
"character_trait_levels_removal_text_wh2_main_trait_lone_wolf_1"	""	"True"
"character_trait_levels_explanation_text_wh2_main_trait_stance_tunneling"	"Spent multiple turns in Use Underway stance"	"True"
"character_trait_levels_onscreen_name_wh2_main_trait_attacking_victory_1"	"Confident Attacker"	"True"
"character_trait_levels_onscreen_name_wh2_main_trait_attacking_victory_2"	"Good Attacker"	"True"
"character_trait_levels_onscreen_name_wh2_main_trait_attacking_victory_3"	"Superior Attacker"	"True"
"character_trait_levels_removal_text_wh_dlc07_trait_brt_lord_bad_scared_of_vampires_1"	""	"True"
"character_trait_levels_explanation_text_wh_dlc07_trait_brt_lord_good_defender_1"	"Gained by winning defensive battles"	"True"
"character_trait_levels_onscreen_name_wh_dlc07_trait_brt_lord_bad_scared_of_vampires_1"	"Moonfear"	"True"
"character_trait_levels_explanation_text_wh_dlc07_trait_brt_lord_good_defender_3"	"Gained by winning defensive battles"	"True"
"character_trait_levels_explanation_text_wh_dlc07_trait_brt_lord_good_defender_2"	"Gained by winning defensive battles"	"True"
"character_trait_levels_explanation_text_wh2_main_trait_defeats_against_chaos"	"Defeated by Chaos"	"True"
"character_trait_levels_explanation_text_wh2_main_trait_def_name_of_power_ca_12_the_tormentor"	""	"True"
"character_trait_levels_explanation_text_wh2_main_trait_ruler_personality_malekith_witch_king"	""	"True"
"character_trait_levels_removal_text_wh2_main_trait_def_name_of_power_ca_09_the_dark_marshall"	""	"True"
"character_trait_levels_colour_text_wh2_main_trait_defeated_azhag_the_slaughterer"	"Heavy is the head that wears the Crown of Sorcery, and probably dead as well!"	"True"
"character_trait_levels_onscreen_name_wh2_main_trait_def_name_of_power_ca_09_the_dark_marshall"	"Name of Power: "the Dark Marshall""	"True"
"character_trait_levels_explanation_text_wh2_main_trait_def_name_of_power_co_08_griefbringer"	""	"True"
"character_trait_levels_colour_text_wh2_main_trait_stance_recruiting"	"Not everyone has the intelligence, wit and warmth of manner to convince others to join their cause."	"True"
"character_trait_levels_explanation_text_wh2_main_trait_defeats_against_dark_elves"	"Defeated by Dark Elves"	"True"
"character_trait_levels_removal_text_wh2_main_trait_defeated_volkmar_the_grim"	""	"True"
"character_trait_levels_colour_text_wh2_main_trait_defeated_durthu"	"Even the mightiest tree in the forest can be felled - you just need a big enough axe!"	"True"
"character_trait_levels_explanation_text_wh2_main_trait_defeated_louen_leoncouer"	"Defeated Louen Leoncoeur"	"True"
"character_trait_levels_onscreen_name_wh2_main_trait_def_name_of_power_ar_03_shadowdart"	"Name of Power: "Shadowdart""	"True"
"character_trait_levels_explanation_text_wh_dlc07_trait_brt_lord_bad_sieging_1"	"Gained by losing siege battles"	"True"
"character_trait_levels_explanation_text_wh_dlc07_trait_brt_lord_bad_sieging_2"	"Gained by losing siege battles"	"True"
"character_trait_levels_explanation_text_wh_dlc07_trait_brt_lord_bad_sieging_3"	"Gained by losing siege battles"	"True"
"character_trait_levels_explanation_text_wh2_main_trait_black_ark_building_wh2_main_horde_def_military_1"	""	"True"
"character_trait_levels_explanation_text_wh2_main_trait_black_ark_building_wh2_main_horde_def_military_3"	""	"True"
"character_trait_levels_explanation_text_wh2_main_trait_black_ark_building_wh2_main_horde_def_military_2"	""	"True"
"character_trait_levels_colour_text_wh_dlc06_trait_name_dummy_da_great_green_prophet"	""	"True"
"character_trait_levels_colour_text_wh2_main_trait_defeated_orion"	"Everyone has a weakness, however well hidden; even immortals must face defeat sometimes."	"True"
"character_trait_levels_explanation_text_wh2_main_trait_defending_defeat_3"	"Suffered defeat in multiple defensive battles"	"True"
"character_trait_levels_explanation_text_wh2_main_trait_defending_defeat_2"	"Suffered defeat in multiple defensive battles"	"True"
"character_trait_levels_explanation_text_wh2_main_trait_defending_defeat_1"	"Suffered defeat in multiple defensive battles"	"True"
"character_trait_levels_onscreen_name_wh2_main_trait_post_battle_execute"	"Executioner"	"True"
"character_trait_levels_onscreen_name_wh2_main_trait_defeated_volkmar_the_grim"	"Grimsbane"	"True"
"character_trait_levels_colour_text_wh2_main_trait_defeated_malagor_the_dark_omen"	"The despoiler becomes the despoiled."	"True"
"character_trait_levels_explanation_text_wh2_main_trait_agent_actions_against_lizardmen"	"Carried out successful [[img:icon_hero]][[/img]]Hero actions against Lizardmen"	"True"
"character_trait_levels_colour_text_wh2_main_trait_siege_victory_1"	"This being brings charts and arithmetic to a siegeâ€¦ promising."	"True"
"character_trait_levels_colour_text_wh2_main_trait_siege_victory_2"	""We'll take them from under the ground, don't you worry - it'll be done soon.""	"True"
"character_trait_levels_colour_text_wh2_main_trait_siege_victory_3"	"Come, men, into the breach I say!"	"True"
"character_trait_levels_colour_text_wh2_main_trait_public_order_3"	"I am the law!"	"True"
"character_trait_levels_colour_text_wh2_main_trait_public_order_2"	""A wise move, my lord - a severe aspect demands respect.""	"True"
"character_trait_levels_colour_text_wh2_main_trait_public_order_1"	"Regimes cannot be maintained without strict discipline."	"True"
"character_trait_levels_onscreen_name_wh2_main_trait_def_name_of_power_ar_11_krakenclaw"	"Name of Power: "Krakenclaw""	"True"
"character_trait_levels_explanation_text_wh2_main_trait_black_ark_building_wh2_main_horde_def_bombardment_a_2"	""	"True"
"character_trait_levels_explanation_text_wh2_main_trait_black_ark_building_wh2_main_horde_def_bombardment_b_2"	""	"True"
"character_trait_levels_explanation_text_wh2_main_trait_black_ark_building_wh2_main_horde_def_bombardment_c_2"	""	"True"
"character_trait_levels_explanation_text_wh2_main_trait_black_ark_building_wh2_main_horde_def_bombardment_a_1"	""	"True"
"character_trait_levels_explanation_text_wh2_main_trait_black_ark_building_wh2_main_horde_def_bombardment_b_1"	""	"True"
"character_trait_levels_explanation_text_wh2_main_trait_black_ark_building_wh2_main_horde_def_bombardment_c_1"	""	"True"
"character_trait_levels_colour_text_wh_dlc07_trait_brt_lord_good_sieging_1"	"This being brings charts and arithmetic to a siegeâ€¦ promising."	"True"
"character_trait_levels_colour_text_wh_dlc07_trait_brt_lord_good_sieging_3"	""Come, men, into the breach I say!""	"True"
"character_trait_levels_colour_text_wh_dlc07_trait_brt_lord_good_sieging_2"	""We'll take them from under the ground, don't you worry - it'll be done soon.""	"True"
"character_trait_levels_removal_text_wh2_main_trait_defeated_grimgor_ironhide"	""	"True"
"character_trait_levels_colour_text_wh2_main_trait_wins_against_rogue_armies"	"Loyalty is an unknown concept to some; such treachery always finds its punishment in due course."	"True"
"character_trait_levels_colour_text_wh2_main_trait_agent_actions_against_humans"	"Men are little more than plague-ridden dogs - put them out of their misery!"	"True"
"character_trait_levels_explanation_text_wh2_main_trait_agent_actions_against_dark_elves"	"Carried out successful [[img:icon_hero]][[/img]]Hero actions against Dark Elves"	"True"
"character_trait_levels_colour_text_wh2_main_trait_defeated_grombrindal"	"This time, the tables have been turned on the last Dawi redoubt, but he'll be back to avenge himself - be certain of that!"	"True"
"character_trait_levels_explanation_text_wh_dlc06_clan_angrund_ancestor_thane_1"	""	"True"
"character_trait_levels_removal_text_wh2_dlc09_trait_defeated_surtha_as_settra"	""	"True"
"character_trait_levels_onscreen_name_wh2_main_trait_black_ark_building_wh2_main_horde_def_sorcery_1"	""	"True"
"character_trait_levels_onscreen_name_wh2_main_trait_black_ark_building_wh2_main_horde_def_sorcery_2"	""	"True"
"character_trait_levels_onscreen_name_wh2_main_trait_defeated_grimgor_ironhide"	"Hidestriker"	"True"
"character_trait_levels_explanation_text_wh_main_trait_name_dummy_the_everchosen"	""	"True"
"character_trait_levels_colour_text_wh2_main_trait_defeated_thorgrim_grudgebearer"	"What to use to pad my mattress\? I know - finest Dwarfbeard!"	"True"
"character_trait_levels_explanation_text_wh2_main_trait_def_name_of_power_ar_07_wrathbringer"	""	"True"
"character_trait_levels_colour_text_wh2_main_trait_stance_stalking"	"This one stalks the land like a giant, stalking thingâ€¦"	"True"
"character_trait_levels_colour_text_wh2_main_trait_corrupted_vampire"	"Wade through blood and spill some more!"	"True"
"character_trait_levels_colour_text_wh2_main_trait_def_name_of_power_ca_10_the_dire_overseer"	""	"True"
"character_trait_levels_onscreen_name_wh_trait_dlc04_helman_not_shown"	"[Hidden] Helman Faction trait"	"True"
"character_trait_levels_explanation_text_wh2_dlc09_trait_defeated_khatep"	"Defeated Grand Hierophant Khatep"	"True"
"character_trait_levels_removal_text_wh2_main_trait_defeated_kroq_gar"	""	"True"
"character_trait_levels_colour_text_wh2_main_trait_wins_against_greenskins"	"Greenskins, like all slimy fungus, must be wiped from the boot whenever trodden upon."	"True"
"character_trait_levels_removal_text_wh2_main_trait_def_name_of_power_ar_12_grimgaze"	""	"True"
"character_trait_levels_onscreen_name_wh2_main_trait_defeated_kroq_gar"	"Saurussmiter"	"True"
"character_trait_levels_onscreen_name_wh_dlc04_trait_name_dummy_the_grim"	""	"True"
"character_trait_levels_colour_text_wh2_main_trait_wins_1"	"Wherever this one goes, news of their recent exploits has generally got there first."	"True"
"character_trait_levels_colour_text_wh2_main_trait_wins_2"	"Never meet your heroes, as they invariably disappoint. This warrior, on the other hand, is the real deal."	"True"
"character_trait_levels_colour_text_wh2_main_trait_wins_3"	""What happens when you are more than a hero\? Why, you transcendâ€¦""	"True"
"character_trait_levels_colour_text_wh_main_trait_all_personality_all_hates_greenskins_1"	"This one despises the Orcs and their foul kin, as all right-thinking beings should."	"True"
"character_trait_levels_explanation_text_wh2_main_trait_agent_action_assault_garrison"	"Carried out successful [[img:icon_hero]][[/img]]Hero actions"	"True"
"character_trait_levels_explanation_text_wh2_main_trait_stance_ambushing"	"Spent multiple turns in Ambush stance"	"True"
"character_trait_levels_explanation_text_wh2_main_trait_pacifist_1"	"Spent a very long time without fighting a single battle"	"True"
"character_trait_levels_explanation_text_wh2_main_trait_pacifist_2"	"Spent a very long time without fighting a single battle"	"True"
"character_trait_levels_explanation_text_wh2_main_trait_pacifist_3"	"Spent a very long time without fighting a single battle"	"True"
"character_trait_levels_colour_text_wh_dlc05_trait_name_dummy_morghur_1"	""	"True"
"character_trait_levels_onscreen_name_wh2_main_trait_reinforcing_humans"	"Likes Men"	"True"
"character_trait_levels_onscreen_name_wh2_main_trait_wins_against_skaven"	"The Exterminator"	"True"
"character_trait_levels_explanation_text_wh2_main_trait_def_name_of_power_co_07_bloodscourge"	""	"True"
"character_trait_levels_explanation_text_wh2_main_trait_razing_1"	"Razed multiple settlements"	"True"
"character_trait_levels_explanation_text_wh2_main_trait_razing_3"	"Razed multiple settlements"	"True"
"character_trait_levels_explanation_text_wh_dlc07_trait_brt_lord_good_peasants_1"	"Gained by maintaining an army consisting mainly of peasants"	"True"
"character_trait_levels_explanation_text_wh2_main_trait_razing_2"	"Razed multiple settlements"	"True"
"character_trait_levels_onscreen_name_wh2_main_trait_defeated_belegar_ironhammer"	"Kinghammer"	"True"
"character_trait_levels_removal_text_wh2_main_trait_reinforcing_dark_elves"	""	"True"
"character_trait_levels_removal_text_wh_dlc07_trait_brt_lord_bad_scared_of_greenskins_1"	""	"True"
"character_trait_levels_removal_text_wh2_main_trait_stance_channeling"	""	"True"
"character_trait_levels_removal_text_wh2_main_trait_defeated_helmen_ghorst"	""	"True"
"character_trait_levels_removal_text_wh2_main_trait_agent_action_assault_unit"	""	"True"
"character_trait_levels_explanation_text_wh2_dlc09_trait_settra_title_start"	""	"True"
"character_trait_levels_removal_text_wh2_dlc09_trait_defeated_settra_as_surtha"	""	"True"
"character_trait_levels_colour_text_wh2_main_trait_defeated_malekith"	"The Dark King will fall, by blade, by arrow, or by sorcerous power and the darkest magic."	"True"
"character_trait_levels_onscreen_name_wh2_main_trait_agent_action_assault_unit"	"\{\{tr:agent_action_assault_unit_name}}"	"True"
"character_trait_levels_onscreen_name_wh2_main_trait_stance_channeling"	"Pious"	"True"
"character_trait_levels_removal_text_wh2_main_trait_stance_forced_march"	""	"True"
"character_trait_levels_explanation_text_wh_main_trait_name_dummy_kemmler"	""	"True"
"character_trait_levels_removal_text_wh2_main_trait_casualties_3"	""	"True"
"character_trait_levels_removal_text_wh2_main_trait_casualties_2"	""	"True"
"character_trait_levels_removal_text_wh2_main_trait_casualties_1"	""	"True"
"character_trait_levels_onscreen_name_wh2_main_trait_ruler_personality_morathi_dark_manipulator"	"Dark Manipulator"	"True"
"character_trait_levels_removal_text_wh2_main_trait_ruler_personality_tyrion_no_politician"	""	"True"
"character_trait_levels_explanation_text_wh2_main_trait_defeated_vlad_von_carstein"	"Defeated Vlad von Carstein"	"True"
"character_trait_levels_onscreen_name_wh2_main_trait_def_name_of_power_ar_08_moonshadow"	"Name of Power: "Moonshadow""	"True"
"character_trait_levels_removal_text_wh_dlc06_clan_angrund_ancestor_master_engineer_1"	""	"True"
"character_trait_levels_explanation_text_wh_dlc07_trait_brt_lord_bad_attacker_2"	"Gained by winning offensive battles"	"True"
"character_trait_levels_explanation_text_wh_dlc07_trait_brt_lord_bad_attacker_3"	"Gained by losing offensive battles"	"True"
"character_trait_levels_explanation_text_wh_dlc07_trait_brt_lord_bad_attacker_1"	"Gained by losing offensive battles"	"True"
"character_trait_levels_explanation_text_wh2_main_trait_agent_action_steal_technology"	"Carried out successful [[img:icon_hero]][[/img]]Hero actions"	"True"
"character_trait_levels_onscreen_name_wh2_main_trait_def_name_of_power_ca_11_gatesmiter"	"Name of Power: "Gatesmiter""	"True"
"character_trait_levels_explanation_text_wh_dlc07_trait_brt_lord_bad_abducter_1"	"Gained by ransoming captives"	"True"
"character_trait_levels_removal_text_wh_trait_dlc04_vlad_vanguard_not_shown"	""	"True"
"character_trait_levels_explanation_text_wh_main_trait_name_dummy_the_magnificent"	""	"True"
"character_trait_levels_colour_text_wh_dlc07_trait_brt_lord_good_praying_1"	"The Lady smiles on those who spend as much time in the chapel as on the battlefield."	"True"
"character_trait_levels_onscreen_name_wh_dlc06_clan_angrund_ancestor_master_engineer_1"	"Clan Angrund Ancestor"	"True"
"character_trait_levels_removal_text_wh2_main_trait_defeated_mannfred_von_carstein"	""	"True"
"character_trait_levels_colour_text_wh2_main_trait_defeated_balthasar_gelt"	"Behind the golden mask lies the face of ignominious defeat."	"True"
"character_trait_levels_colour_text_wh2_main_trait_reinforcing_beastmen"	""Say what you like about the Beastmen, but they never deviate from the plan. They are the most reliable of allies.""	"True"
"character_trait_levels_removal_text_wh2_main_trait_defeated_heinrich_kemmler"	""	"True"
"character_trait_levels_colour_text_wh2_main_trait_brutally_honest"	""That's abject nonsense and you know it!""	"True"
"character_trait_levels_onscreen_name_wh2_main_trait_defending_victory_2"	"Good Defender"	"True"
"character_trait_levels_onscreen_name_wh2_main_trait_defending_victory_3"	"Superior Defender"	"True"
"character_trait_levels_onscreen_name_wh2_main_trait_defending_victory_1"	"Confident Defender"	"True"
"character_trait_levels_explanation_text_wh2_main_trait_ruler_personality_queek_hates_dwarfs_greenskins"	""	"True"
"character_trait_levels_onscreen_name_wh2_main_trait_defeated_heinrich_kemmler"	"Lichekiller"	"True"
"character_trait_levels_explanation_text_wh2_main_trait_def_name_of_power_co_11_drakecleaver"	""	"True"
"character_trait_levels_colour_text_wh2_main_trait_defeated_isabella_von_carstein"	"Stone-cold beauty is no guarantee of victory."	"True"
"character_trait_levels_onscreen_name_wh2_main_trait_reinforcing_dwarfs"	"Likes Dwarfs"	"True"
"character_trait_levels_removal_text_wh_dlc07_trait_brt_lord_good_public_order_1"	""	"True"
"character_trait_levels_onscreen_name_wh2_dlc09_trait_benevolence"	"Merciful Master"	"True"
"character_trait_levels_explanation_text_wh_dlc06_wurrzag_anti_trait_1"	""	"True"
"character_trait_levels_colour_text_wh2_main_trait_defeated_prince_sigvald"	"Pride comes before a fall. Always."	"True"
"character_trait_levels_colour_text_wh2_main_trait_siege_defeat_2"	"How do you attack a wall\?"	"True"
"character_trait_levels_colour_text_wh2_main_trait_siege_defeat_3"	"Those walls look solid and tall."	"True"
"character_trait_levels_removal_text_wh2_main_trait_defeated_skarsnik"	""	"True"
"character_trait_levels_colour_text_wh2_main_trait_siege_defeat_1"	"Sieges are hard, this one has no idea."	"True"
"character_trait_levels_onscreen_name_wh2_main_trait_def_name_of_power_ca_07_barbedlash"	"Name of Power: "Barbedlash""	"True"
"character_trait_levels_onscreen_name_wh_main_trait_name_dummy_ironhide"	"."	"True"
"character_trait_levels_colour_text_wh2_main_trait_reinforcing_high_elves"	"Their ever-present aloofness aside, this one finds the Asur trustworthy allies when it comes down to it - as it frequently does."	"True"
"character_trait_levels_onscreen_name_wh_main_trait_name_dummy_suneater"	"."	"True"
"character_trait_levels_explanation_text_wh_dlc07_trait_brt_lord_good_beastmen_1"	"Gained by winning battles against Beastmen factions"	"True"
"character_trait_levels_onscreen_name_wh2_main_trait_defeated_skarsnik"	"Sneakysmiter"	"True"
"character_trait_levels_removal_text_wh2_main_trait_defeats_against_lizardmen"	""	"True"
"character_trait_levels_colour_text_wh_dlc07_trait_brt_lord_bad_scared_of_beastmen_1"	"Even the greatest general finds it difficult to anticipate the movements of the unruly and aberrant beasts."	"True"
"character_trait_levels_explanation_text_wh_main_trait_dummy_title_emperor"	""	"True"
"character_trait_levels_colour_text_wh2_main_trait_defeated_archaon_the_everchosen"	"The Everchosen may rise and rise again, but he will forever be consigned to oblivion!"	"True"
"character_trait_levels_onscreen_name_wh_dlc07_trait_brt_lord_good_reinforcing_1"	"Saviour"	"True"
"character_trait_levels_onscreen_name_wh2_main_trait_defeats_against_lizardmen"	"Fears Lizardmen"	"True"
"character_trait_levels_explanation_text_wh2_main_trait_def_name_of_power_ca_03_khainemarked"	""	"True"
"character_trait_levels_colour_text_wh2_main_trait_def_name_of_power_ar_05_beastbinder"	""	"True"
"character_trait_levels_colour_text_wh2_main_trait_reinforcing_vampires"	"We all die eventually, better to bring the masters of death to the cause sooner rather than later."	"True"
"character_trait_levels_removal_text_wh2_dlc09_trait_benevolence"	""	"True"
"character_trait_levels_removal_text_wh2_main_trait_stance_recruiting"	""	"True"
"character_trait_levels_onscreen_name_wh_dlc06_trait_name_dummy_da_great_green_prophet"	""	"True"
"character_trait_levels_colour_text_wh2_main_trait_defeated_volkmar_the_grim"	"All the piety in the Old World means nothing when faced with superior military muscle."	"True"
"character_trait_levels_removal_text_wh_dlc06_trait_name_dummy_da_great_green_prophet"	""	"True"
"character_trait_levels_explanation_text_wh2_dlc09_dummy_trait_dynasty_4"	""	"True"
"character_trait_levels_explanation_text_wh2_dlc09_dummy_trait_dynasty_5"	""	"True"
"character_trait_levels_onscreen_name_wh2_main_trait_stance_recruiting"	"Recruiter"	"True"
"character_trait_levels_explanation_text_wh2_dlc09_dummy_trait_dynasty_6"	""	"True"
"character_trait_levels_explanation_text_wh2_dlc09_dummy_trait_dynasty_1"	""	"True"
"character_trait_levels_explanation_text_wh2_dlc09_dummy_trait_dynasty_2"	""	"True"
"character_trait_levels_explanation_text_wh2_dlc09_dummy_trait_dynasty_3"	""	"True"
"character_trait_levels_explanation_text_wh2_main_trait_def_name_of_power_ar_01_lifequencher"	""	"True"
"character_trait_levels_colour_text_wh2_main_trait_def_favoured"	"Such unwavering loyalty is rare; it is best to keep this subject close by granting them control over some small fiefdom."	"True"
"character_trait_levels_explanation_text_wh2_main_trait_black_ark_building_wh2_main_horde_def_settlement_2"	""	"True"
"character_trait_levels_explanation_text_wh2_main_trait_black_ark_building_wh2_main_horde_def_settlement_3"	""	"True"
"character_trait_levels_explanation_text_wh2_main_trait_black_ark_building_wh2_main_horde_def_settlement_4"	""	"True"
"character_trait_levels_explanation_text_wh2_main_trait_black_ark_building_wh2_main_horde_def_settlement_5"	""	"True"
"character_trait_levels_removal_text_wh2_main_trait_wins_1"	""	"True"
"character_trait_levels_removal_text_wh2_main_trait_wins_2"	""	"True"
"character_trait_levels_removal_text_wh2_main_trait_wins_3"	""	"True"
"character_trait_levels_explanation_text_wh_dlc07_trait_brt_lord_bad_perverted_1"	"Gained by spending turns in a region with a Brothel"	"True"
"character_trait_levels_onscreen_name_wh_main_trait_name_dummy_the_ever-watcher"	"."	"True"
"character_trait_levels_colour_text_wh2_main_trait_defeated_grimgor_ironhide"	"This hide is perhaps not as durable as it originally thoughtâ€¦"	"True"
"character_trait_levels_removal_text_wh2_main_trait_wins_against_rogue_armies"	""	"True"
"character_trait_levels_colour_text_wh2_main_trait_defeated_helmen_ghorst"	"Apparently death is merely an obstacle to be overcome; must be inconvenient, however."	"True"
"character_trait_levels_onscreen_name_wh2_main_trait_wins_against_rogue_armies"	"Viperkiller"	"True"
"character_trait_levels_colour_text_wh2_main_trait_reinforcing_dark_elves"	"Sometimes a penchant for cruelty can be utilised for the greater good. Well, for mutual benefit anywayâ€¦"	"True"
"character_trait_levels_removal_text_wh2_main_trait_agent_actions_against_chaos"	""	"True"
"character_trait_levels_colour_text_wh2_dlc09_trait_defeated_settra_as_surtha"	""That's not a chariot... \*This\* is a chariot!""	"True"
"character_trait_levels_explanation_text_wh_dlc07_trait_brt_lord_good_industry_1"	"Gained by being present when industry was built"	"True"
"character_trait_levels_colour_text_wh2_main_trait_skv_flayed_tail"	"It's always sensible to stay on the good side of your betters..."	"True"
"character_trait_levels_removal_text_wh2_main_trait_corrupted_vampire"	""	"True"
"character_trait_levels_colour_text_wh2_main_trait_defeated_tyrion"	"Now the Asur's greatest warrior has been laid low, what of the island kingdom he is sworn to protect\?"	"True"
"character_trait_levels_colour_text_wh2_main_trait_wounded"	"Having survived numerous assassination attempts, this one is naturally a little hesitant in daily life."	"True"
"character_trait_levels_removal_text_wh2_main_trait_def_name_of_power_ca_10_the_dire_overseer"	""	"True"
"character_trait_levels_explanation_text_wh_dlc07_trait_brt_lord_bad_defender_1"	"Gained by losing defensive battles"	"True"
"character_trait_levels_explanation_text_wh_dlc07_trait_brt_lord_bad_defender_2"	"Gained by losing defensive battles"	"True"
"character_trait_levels_explanation_text_wh_dlc07_trait_brt_lord_bad_defender_3"	"Gained by losing defensive battles"	"True"
"character_trait_levels_colour_text_wh2_main_trait_defeated_morghur_the_shadowgave"	"Faced with an opponent of the right calibre, even the Shadowgave can be bested."	"True"
"character_trait_levels_onscreen_name_wh2_main_trait_def_name_of_power_ar_06_fangshield"	"Name of Power: "Fangshield""	"True"
"character_trait_levels_onscreen_name_wh2_main_trait_black_ark_building_wh2_main_horde_def_slavery_1"	""	"True"
"character_trait_levels_onscreen_name_wh2_main_trait_black_ark_building_wh2_main_horde_def_slavery_2"	""	"True"
"character_trait_levels_onscreen_name_wh2_main_trait_black_ark_building_wh2_main_horde_def_slavery_3"	""	"True"
"character_trait_levels_onscreen_name_wh2_main_trait_corrupted_vampire"	"Bloodlust"	"True"
"character_trait_levels_colour_text_wh2_main_trait_ruler_personality_tyrion_no_politician"	""I have no time for these petty court intrigues. Do or do not, and be damned with you!""	"True"
"character_trait_levels_onscreen_name_wh2_main_trait_wins_against_chaos"	"Ruin's End"	"True"
"character_trait_levels_onscreen_name_wh_dlc07_trait_brt_lord_good_public_order_1"	"Authoritarian"	"True"
"character_trait_levels_explanation_text_wh2_main_trait_wins_at_sea_3"	"Achieved victory in multiple naval battles"	"True"
"character_trait_levels_explanation_text_wh2_main_trait_wins_at_sea_2"	"Achieved victory in multiple naval battles"	"True"
"character_trait_levels_explanation_text_wh2_main_trait_wins_at_sea_1"	"Achieved victory in multiple naval battles"	"True"
"character_trait_levels_explanation_text_wh2_main_trait_wins_against_wood_elves"	"Achieved victory over Wood Elves multiple times"	"True"
"character_trait_levels_explanation_text_wh_main_trait_name_dummy_the_slaughterer"	""	"True"
"character_trait_levels_onscreen_name_wh2_main_trait_def_name_of_power_ca_10_the_dire_overseer"	"Name of Power: "the Dire Overseer""	"True"
"character_trait_levels_removal_text_wh2_main_trait_stance_astromancy"	""	"True"
"character_trait_levels_explanation_text_wh2_main_trait_defeated_queen_headtaker"	"Defeated Queek Headtaker"	"True"
"character_trait_levels_onscreen_name_wh_main_trait_general_personality_vmp_black_arts_1"	"Student of the Black Arts"	"True"
"character_trait_levels_onscreen_name_wh2_main_trait_stance_astromancy"	"Astronomer"	"True"
"character_trait_levels_colour_text_wh2_main_trait_defeated_mannfred_von_carstein"	"He who quenches his thirst on the blood of the living will find cold steel his just reward."	"True"
"character_trait_levels_onscreen_name_wh2_main_trait_casualties_3"	"Gore-Drenched"	"True"
"character_trait_levels_onscreen_name_wh2_main_trait_casualties_2"	"Blood-Reveller"	"True"
"character_trait_levels_onscreen_name_wh2_main_trait_casualties_1"	"Bloody"	"True"
"character_trait_levels_removal_text_wh2_main_trait_exploring"	""	"True"
"character_trait_levels_explanation_text_wh_main_trait_all_personality_all_hates_dwarfs_1"	""	"True"
"character_trait_levels_removal_text_wh2_main_trait_defeated_isabella_von_carstein"	""	"True"
"character_trait_levels_onscreen_name_wh2_main_trait_def_name_of_power_co_04_headreaper"	"Name of Power: "Headreaper""	"True"
"character_trait_levels_colour_text_wh2_main_trait_defeated_teclis"	"With Teclis defeated, who will drive back the forces of Chaos from the world\?"	"True"
"character_trait_levels_colour_text_wh2_main_trait_skv_boom_master"	""Light the blue touch-paper and stand well back No, further back than that!""	"True"
"character_trait_levels_explanation_text_wh2_main_trait_agent_actions_against_wood_elves"	"Carried out successful [[img:icon_hero]][[/img]]Hero actions against Wood Elves"	"True"
"character_trait_levels_onscreen_name_wh2_main_trait_exploring"	"Explorer"	"True"
"character_trait_levels_removal_text_wh2_dlc09_trait_settra_title_1"	""	"True"
"character_trait_levels_onscreen_name_wh2_main_trait_skv_one_eye"	"One-Eyed"	"True"
"character_trait_levels_removal_text_wh2_dlc09_trait_settra_title_3"	""	"True"
"character_trait_levels_removal_text_wh2_dlc09_trait_settra_title_2"	""	"True"
"character_trait_levels_explanation_text_wh_dlc03_trait_name_dummy_the_one_eye"	""	"True"
"character_trait_levels_explanation_text_wh2_main_trait_post_battle_ransom"	"Ransomed captives after battle multiple times"	"True"
"character_trait_levels_colour_text_wh_main_trait_name_dummy_de_bordeleaux"	""	"True"
"character_trait_levels_explanation_text_wh2_dlc09_trait_defeated_arkhan"	"Defeated Arkhan the Black"	"True"
"character_trait_levels_removal_text_wh2_main_trait_reinforcing_high_elves"	""	"True"
"character_trait_levels_colour_text_wh2_main_trait_agent_actions_against_skaven"	"No one really likes Skaven and if they say otherwise, they're lying. This one, however, hates them with every ounce of their being."	"True"
"character_trait_levels_colour_text_wh_dlc07_trait_brt_lord_bad_scared_of_vampires_1"	"The pale, exsanguinated moon waxed full in the starry sky when the Unliving began their butcheryâ€¦"	"True"
"character_trait_levels_explanation_text_wh_dlc07_trait_brt_lord_bad_scared_of_chaos_1"	"Gained by losing battles against Chaos factions"	"True"
"character_trait_levels_explanation_text_wh2_main_trait_def_name_of_power_ca_04_the_black_conqueror"	""	"True"
"character_trait_levels_onscreen_name_wh2_main_trait_black_ark_building_wh2_main_horde_def_worship_1"	""	"True"
"character_trait_levels_onscreen_name_wh2_main_trait_black_ark_building_wh2_main_horde_def_worship_2"	""	"True"
"character_trait_levels_onscreen_name_wh2_main_trait_def_name_of_power_ar_12_grimgaze"	"Name of Power: "Grimgaze""	"True"
"character_trait_levels_colour_text_wh_dlc07_trait_brt_lord_good_victory_2"	""Let your name be on the lips of every man and woman; your great deeds go before you!""	"True"
"character_trait_levels_removal_text_wh2_main_trait_siege_defeat_2"	""	"True"
"character_trait_levels_colour_text_wh_dlc07_trait_brt_lord_good_victory_3"	""What happens when you are more than a hero\? Why, you transcendâ€¦""	"True"
"character_trait_levels_explanation_text_wh2_main_trait_routed_1"	"Routed during battle multiple times"	"True"
"character_trait_levels_removal_text_wh2_main_trait_siege_defeat_3"	""	"True"
"character_trait_levels_explanation_text_wh2_main_trait_routed_2"	"Routed during battle multiple times"	"True"
"character_trait_levels_colour_text_wh_dlc07_trait_brt_lord_good_victory_1"	""You must fight, for it is what you do. It is what you are good at.""	"True"
"character_trait_levels_explanation_text_wh2_main_trait_routed_3"	"Routed during battle multiple times"	"True"
"character_trait_levels_removal_text_wh2_main_trait_siege_defeat_1"	""	"True"
"character_trait_levels_onscreen_name_wh2_main_trait_agent_action_assault_units"	"\{\{tr:agent_action_assault_units_name}}"	"True"
"character_trait_levels_colour_text_wh2_main_trait_def_name_of_power_co_03_poisonblade"	""	"True"
"character_trait_levels_explanation_text_wh2_dlc09_trait_defeated_settra"	"Defeated Settra the Imperishable"	"True"
"character_trait_levels_explanation_text_wh2_main_trait_defeats_against_wood_elves"	"Defeated by Wood Elves"	"True"
"character_trait_levels_explanation_text_wh_main_trait_general_personality_vmp_summon_creatures_1"	""	"True"
"character_trait_levels_onscreen_name_wh2_main_trait_def_name_of_power_ca_06_emeraldeye"	"Name of Power: "Emeraldeye""	"True"
"character_trait_levels_colour_text_wh2_main_trait_def_name_of_power_ca_09_the_dark_marshall"	""	"True"
"character_trait_levels_colour_text_wh2_main_trait_defeated_lord_strolk"	"His dreadful staff, and the disease it spreads, cannot save Skrolk from the righteous scourge."	"True"
"character_trait_levels_explanation_text_wh_dlc07_trait_brt_lord_good_vampires_1"	"Gained by winning battles against Vampire factions"	"True"
"character_trait_levels_explanation_text_wh2_main_trait_corrupted_chaos"	"Present in a region with high [[img:icon_corruption_chs]][[/img]]Chaos corruption"	"True"
"character_trait_levels_explanation_text_wh2_main_trait_non_corrupted"	"Spent multiple turns in an owned region with little to no corruption"	"True"
"character_trait_levels_explanation_text_wh2_main_trait_ruler_personality_morathi_dark_manipulator"	""	"True"
"character_trait_levels_explanation_text_wh_dlc03_trait_name_dummy_the_dark_omen"	""	"True"
"character_trait_levels_removal_text_wh2_main_trait_post_battle_execute"	""	"True"
"character_trait_levels_explanation_text_wh_dlc07_trait_brt_lord_good_defeated_khazrak_1"	"Gained by defeating Khazrak One-Eye in battle"	"True"
"character_trait_levels_removal_text_wh2_main_trait_def_assassins_end"	""	"True"
"character_trait_levels_onscreen_name_wh2_main_trait_defeated_vlad_von_carstein"	"Undeath Descendant"	"True"
"character_trait_levels_explanation_text_wh2_main_trait_defeats_at_sea_1"	"Suffered defeat in multiple naval battles"	"True"
"character_trait_levels_explanation_text_wh2_main_trait_defeats_at_sea_3"	"Suffered defeat in multiple naval battles"	"True"
"character_trait_levels_explanation_text_wh2_main_trait_defeats_at_sea_2"	"Suffered defeat in multiple naval battles"	"True"
"character_trait_levels_onscreen_name_wh2_main_trait_def_assassins_end"	"Assassin's End"	"True"
"character_trait_levels_colour_text_wh2_main_trait_def_name_of_power_ca_02_darkpath"	""	"True"
"character_trait_levels_explanation_text_wh2_main_trait_def_name_of_power_ar_08_moonshadow"	""	"True"
"character_trait_levels_explanation_text_wh2_main_trait_def_name_of_power_ca_11_gatesmiter"	""	"True"
"character_trait_levels_removal_text_wh2_main_trait_reinforcing_chaos"	""	"True"
"character_trait_levels_colour_text_wh2_main_trait_general_status_all_cursed"	"Somewhere there's a reason why some things just fall through."	"True"
"character_trait_levels_removal_text_wh2_main_trait_agent_action_damage_building"	""	"True"
"character_trait_levels_removal_text_wh2_main_trait_def_name_of_power_ar_04_barbstorm"	""	"True"
"character_trait_levels_removal_text_wh2_main_trait_agent_action_damage_walls"	""	"True"
"character_trait_levels_onscreen_name_wh2_main_trait_agent_actions_against_dwarfs"	"Hates Dwarfs"	"True"
"character_trait_levels_colour_text_wh_main_trait_name_dummy_gelt"	"."	"True"
"character_trait_levels_onscreen_name_wh2_main_trait_def_name_of_power_ar_04_barbstorm"	"Name of Power: "Barbstorm""	"True"
"character_trait_levels_removal_text_wh2_main_trait_black_ark_building_wh2_main_horde_def_sorcery_2"	""	"True"
"character_trait_levels_removal_text_wh2_main_trait_black_ark_building_wh2_main_horde_def_sorcery_1"	""	"True"
"character_trait_levels_onscreen_name_wh2_main_trait_reinforcing_chaos"	"Likes Chaos"	"True"
"character_trait_levels_onscreen_name_wh2_main_trait_agent_action_damage_walls"	"\{\{tr:agent_action_damage_walls_name}}"	"True"
"character_trait_levels_onscreen_name_wh2_main_trait_pacifist_1"	"Dislikes War"	"True"
"character_trait_levels_onscreen_name_wh2_main_trait_pacifist_3"	"Pacifist"	"True"
"character_trait_levels_onscreen_name_wh2_main_trait_pacifist_2"	"Appeaser"	"True"
"character_trait_levels_removal_text_wh2_main_trait_defeated_alberic_de_bordeleaux"	""	"True"
"character_trait_levels_explanation_text_wh2_main_trait_reinforcing_humans"	"Reinforced the armies of Men in battle multiple times"	"True"
"character_trait_levels_explanation_text_wh2_main_trait_defeated_wurzzag"	"Defeated Wurrzag Da Great Green Prophet"	"True"
"character_trait_levels_colour_text_wh_dlc04_trait_name_dummy_ghorst"	""	"True"
"character_trait_levels_explanation_text_wh_main_trait_name_dummy_blank"	""	"True"
"character_trait_levels_colour_text_wh2_dlc09_trait_spymaster"	"This one has an array of agents at his disposal, has \*all\* the cards, and pulls \*all\* the strings â€“ tread carefully in his presence and beware!"	"True"
"character_trait_levels_explanation_text_wh_main_trait_name_dummy_franz"	""	"True"
"character_trait_levels_colour_text_wh2_main_trait_reinforcing_greenskins"	"Bring them war and the Orcs will thank you."	"True"
"character_trait_levels_colour_text_wh2_main_trait_wins_against_lizardmen"	"Having a plan isn't always enough; sometimes you need insight, sometimes foresight, but always martial strength."	"True"
"character_trait_levels_colour_text_wh2_dlc09_trait_defeated_khalida"	"The Warrior-Queen was defeated once before in life â€“ fatally. Although she was saved by the blessings of the Asp-Goddess then, they cannot save her now."	"True"
"character_trait_levels_explanation_text_wh_main_trait_name_dummy_suneater"	""	"True"
"character_trait_levels_colour_text_wh2_main_trait_agent_action_block_army"	"\{\{tr:agent_action_block_army_description}}"	"True"
"character_trait_levels_explanation_text_wh_main_trait_name_dummy_ironhide"	""	"True"
"character_trait_levels_explanation_text_wh2_main_trait_corrupted_skaven"	"Present in a region with high [[img:icon_corruption_skv]][[/img]]Skaven corruption"	"True"
"character_trait_levels_removal_text_wh_dlc07_trait_brt_lord_bad_kingslayer_1"	""	"True"
"character_trait_levels_removal_text_wh_main_trait_general_personality_vmp_dark_acolyte_1"	""	"True"
"character_trait_levels_onscreen_name_wh_dlc06_wurrzag_anti_trait_1"	"[HIDDEN]"	"True"
"character_trait_levels_explanation_text_wh2_main_trait_def_name_of_power_co_10_fatedshield"	""	"True"
"character_trait_levels_onscreen_name_wh_main_trait_general_personality_vmp_dark_acolyte_1"	"Dark Acolyte"	"True"
"character_trait_levels_explanation_text_wh2_main_trait_def_name_of_power_ca_07_barbedlash"	""	"True"
"character_trait_levels_onscreen_name_wh_dlc07_trait_brt_lord_bad_kingslayer_1"	"Kingslayer"	"True"
"character_trait_levels_onscreen_name_wh2_main_trait_defeats_3"	"Disgraced"	"True"
"character_trait_levels_onscreen_name_wh2_main_trait_defeats_2"	"Ashamed"	"True"
"character_trait_levels_onscreen_name_wh2_main_trait_defeats_1"	"Embarrassed"	"True"
"character_trait_levels_explanation_text_wh2_main_trait_skv_musk_of_the_overlord"	"Awarded through a Loyalty dilemma."	"True"
"character_trait_levels_explanation_text_wh2_main_trait_defeated_fay_enchantress"	"Defeated the Fay Enchantress"	"True"
"character_trait_levels_colour_text_wh2_main_trait_wins_against_high_elves"	"Such high-minded ways and pure ideals count for nothing when youâ€™re wormfood."	"True"
"character_trait_levels_colour_text_wh2_main_trait_defeats_against_skaven"	"The chatter, the stench, the pox-ridden fur - all repel this one greatly. They cannot bear to be in the presence of Skaven."	"True"
"character_trait_levels_removal_text_wh2_main_trait_defeats_1"	""	"True"
"character_trait_levels_removal_text_wh2_main_trait_defeats_2"	""	"True"
"character_trait_levels_removal_text_wh2_main_trait_defeats_3"	""	"True"
"character_trait_levels_colour_text_wh_dlc07_trait_brt_lord_bad_renegade_1"	"Some consider fighting the Empire a distraction, but others feel its arrogance must be checked!"	"True"
"character_trait_levels_onscreen_name_wh_main_trait_dummy_title_emperor"	"."	"True"
"character_trait_levels_removal_text_wh2_main_trait_attacking_victory_2"	""	"True"
"character_trait_levels_removal_text_wh2_main_trait_attacking_victory_3"	""	"True"
"character_trait_levels_removal_text_wh2_main_trait_attacking_victory_1"	""	"True"
"character_trait_levels_onscreen_name_wh2_main_trait_defeated_grombrindal"	"Beardhammer"	"True"
"character_trait_levels_onscreen_name_wh2_main_trait_lone_wolf_1"	"Solitary"	"True"
"character_trait_levels_onscreen_name_wh2_main_trait_lone_wolf_3"	"Lone Wolf"	"True"
"character_trait_levels_onscreen_name_wh2_main_trait_lone_wolf_2"	"Independent"	"True"
"character_trait_levels_onscreen_name_wh2_main_trait_agent_actions_against_humans"	"Hates Men"	"True"
"character_trait_levels_explanation_text_wh_dlc07_trait_brt_lord_good_farming_1"	"Gained by being present when farms were built"	"True"
"character_trait_levels_colour_text_wh2_main_trait_stance_raiding"	""Our lands provide for all; THIS land provides for ME!""	"True"
"character_trait_levels_explanation_text_wh2_main_trait_def_name_of_power_ar_10_the_grey_vanquisher"	""	"True"
"character_trait_levels_explanation_text_wh2_main_trait_reinforcing_dwarfs"	"Reinforced Dwarfen armies in battle multiple times"	"True"
"character_trait_levels_removal_text_wh2_main_trait_slaver"	""	"True"
"character_trait_levels_colour_text_wh_trait_dlc04_helman_not_shown"	"[Hidden] Helman Faction trait"	"True"
"character_trait_levels_onscreen_name_wh2_main_trait_fighter_1"	"Bold"	"True"
"character_trait_levels_onscreen_name_wh2_main_trait_fighter_2"	"Brave"	"True"
"character_trait_levels_explanation_text_wh2_main_trait_defeated_ungrim_ironfist"	"Defeated Ungrim Ironfist"	"True"
"character_trait_levels_onscreen_name_wh2_main_trait_fighter_3"	"Fearless"	"True"
"character_trait_levels_colour_text_wh2_main_trait_skv_badly_mutated"	"You can never have too much Warpstone. No, really!"	"True"
"character_trait_levels_removal_text_wh2_main_trait_defeated_grombrindal"	""	"True"
"character_trait_levels_colour_text_wh2_main_trait_agent_action_hinder_replenishment"	"\{\{tr:agent_action_hinder_replenishment_description}}"	"True"
"character_trait_levels_removal_text_wh2_main_trait_agent_actions_against_humans"	""	"True"
"character_trait_levels_removal_text_wh2_main_trait_fighter_3"	""	"True"
"character_trait_levels_removal_text_wh2_main_trait_fighter_2"	""	"True"
"character_trait_levels_removal_text_wh2_main_trait_fighter_1"	""	"True"
"character_trait_levels_explanation_text_wh2_main_trait_def_name_of_power_ca_01_dreadtongue"	""	"True"
"character_trait_levels_explanation_text_wh2_main_trait_far_from_capital"	"Fought multiple battles very far away from the capital"	"True"
"character_trait_levels_explanation_text_wh2_main_trait_wins_against_chaos"	"Achieved victory over Chaos multiple times"	"True"
"character_trait_levels_colour_text_wh2_main_trait_wins_against_dark_elves"	"The Druchii, for all their perverse cruelty, are just Elves - as fey and wan as others of their kind."	"True"
"character_trait_levels_explanation_text_wh2_main_trait_defeated_khazrak_one_eye"	"Defeated Khazrak the One-Eye"	"True"
"character_trait_levels_removal_text_wh2_main_trait_wins_against_dwarfs"	""	"True"
"character_trait_levels_explanation_text_wh2_main_trait_def_name_of_power_ar_06_fangshield"	""	"True"
"character_trait_levels_removal_text_wh2_main_trait_reinforcing"	""	"True"
"character_trait_levels_removal_text_wh_main_trait_name_dummy_gelt"	""	"True"
"character_trait_levels_onscreen_name_wh2_main_trait_defeated_karl_franz"	"Reikshammer"	"True"
"character_trait_levels_removal_text_wh2_main_trait_reinforcing_greenskins"	""	"True"
"character_trait_levels_removal_text_wh2_main_trait_wins_against_lizardmen"	""	"True"
"character_trait_levels_removal_text_wh2_dlc09_trait_spymaster"	""	"True"
"character_trait_levels_onscreen_name_wh2_main_trait_sacking_1"	"Looter"	"True"
"character_trait_levels_onscreen_name_wh2_main_trait_sacking_2"	"Butcher"	"True"
"character_trait_levels_onscreen_name_wh2_main_trait_sacking_3"	"Destroyer"	"True"
"character_trait_levels_explanation_text_wh2_main_trait_agent_action_assassinate"	"Carried out successful [[img:icon_hero]][[/img]]Hero actions"	"True"
"character_trait_levels_removal_text_wh2_main_trait_agent_target_fail_3"	""	"True"
"character_trait_levels_colour_text_wh2_main_trait_def_name_of_power_co_09_the_hand_of_wrath"	""	"True"
"character_trait_levels_removal_text_wh2_main_trait_agent_target_fail_2"	""	"True"
"character_trait_levels_removal_text_wh2_main_trait_agent_target_fail_1"	""	"True"
"character_trait_levels_explanation_text_wh_dlc07_trait_brt_lord_bad_coward_1"	"Gained by retreating in battle"	"True"
"character_trait_levels_explanation_text_wh_main_trait_name_dummy_the_ever-watcher"	""	"True"
"character_trait_levels_removal_text_wh2_main_trait_sacking_3"	""	"True"
"character_trait_levels_removal_text_wh2_main_trait_sacking_2"	""	"True"
"character_trait_levels_removal_text_wh2_main_trait_sacking_1"	""	"True"
"character_trait_levels_removal_text_wh_main_trait_name_dummy_leoncoeur"	""	"True"
"character_trait_levels_onscreen_name_wh2_main_trait_black_ark_building_wh2_main_horde_def_settlement_3"	""	"True"
"character_trait_levels_onscreen_name_wh2_main_trait_black_ark_building_wh2_main_horde_def_settlement_2"	""	"True"
"character_trait_levels_onscreen_name_wh2_main_trait_black_ark_building_wh2_main_horde_def_settlement_5"	""	"True"
"character_trait_levels_onscreen_name_wh2_main_trait_black_ark_building_wh2_main_horde_def_settlement_4"	""	"True"
"character_trait_levels_colour_text_wh2_main_trait_defeated_alberic_de_bordeleaux"	"Outstanding personal courage and martial skill are not always enough. Today, the hammer became the anvil."	"True"
"character_trait_levels_removal_text_wh_dlc07_trait_brt_lord_good_executing_1"	""	"True"
"character_trait_levels_colour_text_wh_dlc07_trait_brt_lord_good_lone_wolf_2"	"Prowling. Waiting. Patient. Alone. Deadly."	"True"
"character_trait_levels_onscreen_name_wh2_main_trait_builder_1"	"Builder"	"True"
"character_trait_levels_colour_text_wh_dlc07_trait_brt_lord_good_lone_wolf_1"	""I alone can fix this; I alone.""	"True"
"character_trait_levels_onscreen_name_wh2_main_trait_builder_2"	"Engineer"	"True"
"character_trait_levels_onscreen_name_wh2_main_trait_builder_3"	"Architect"	"True"
"character_trait_levels_onscreen_name_wh2_main_trait_agent_action_damage_building"	"\{\{tr:agent_action_damage_building_name}}"	"True"
"character_trait_levels_onscreen_name_wh_dlc07_trait_brt_lord_bad_lazy_1"	"Procrastinator"	"True"
"character_trait_levels_onscreen_name_wh_dlc07_trait_brt_lord_bad_lazy_2"	"Lazy"	"True"
"character_trait_levels_explanation_text_wh2_main_trait_agent_action_assault_units"	"Carried out successful [[img:icon_hero]][[/img]]Hero actions"	"True"
"character_trait_levels_explanation_text_wh_dlc07_trait_brt_lord_good_sieging_1"	"Gained by winning siege battles"	"True"
"character_trait_levels_explanation_text_wh_dlc07_trait_brt_lord_good_sieging_3"	"Gained by winning siege battles"	"True"
"character_trait_levels_explanation_text_wh_dlc07_trait_brt_lord_good_sieging_2"	"Gained by winning siege battles"	"True"
"character_trait_levels_removal_text_wh2_main_trait_agent_actions_against_dwarfs"	""	"True"
"character_trait_levels_onscreen_name_wh2_main_trait_post_battle_ransom"	"Abducter"	"True"
"character_trait_levels_onscreen_name_wh_dlc07_trait_brt_lord_good_executing_1"	"Purifier"	"True"
"character_trait_levels_removal_text_wh2_main_trait_builder_3"	""	"True"
"character_trait_levels_removal_text_wh2_main_trait_builder_2"	""	"True"
"character_trait_levels_removal_text_wh2_main_trait_builder_1"	""	"True"
"character_trait_levels_onscreen_name_wh_dlc07_trait_brt_lord_bad_scared_of_chaos_1"	"Fear of Ruin"	"True"
"character_trait_levels_removal_text_wh2_main_trait_defeats_against_skaven"	""	"True"
"character_trait_levels_colour_text_wh2_main_trait_def_name_of_power_co_06_soulblaze"	""	"True"
"character_trait_levels_colour_text_wh2_main_trait_agent_actions_against_lizardmen"	""Great, big, slimy lizards, doing everything according to their grand 'plan' - they think they're better than us.""	"True"
"character_trait_levels_explanation_text_wh2_main_trait_siege_victory_1"	"Achieved victory in multiple siege battles"	"True"
"character_trait_levels_explanation_text_wh2_main_trait_siege_victory_2"	"Achieved victory in multiple siege battles"	"True"
"character_trait_levels_explanation_text_wh2_main_trait_siege_victory_3"	"Achieved victory in multiple siege battles"	"True"
"character_trait_levels_onscreen_name_wh2_main_trait_defeats_against_wood_elves"	"Fears Wood Elves"	"True"
"character_trait_levels_explanation_text_wh2_main_trait_def_name_of_power_ca_06_emeraldeye"	""	"True"
"character_trait_levels_removal_text_wh2_main_trait_wins_against_humans"	""	"True"
"character_trait_levels_explanation_text_wh2_main_trait_defeated_durthu"	"Defeated Durthu"	"True"
"character_trait_levels_explanation_text_wh_main_trait_supreme_patriarch"	""	"True"
"character_trait_levels_removal_text_wh2_main_trait_def_name_of_power_co_02_wyrmscale"	""	"True"
"character_trait_levels_removal_text_wh2_main_trait_stance_raiding"	""	"True"
"character_trait_levels_explanation_text_wh2_main_trait_stance_stalking"	"Spent multiple turns in Stalking stance"	"True"
"character_trait_levels_onscreen_name_wh2_main_trait_def_name_of_power_co_02_wyrmscale"	"Name of Power: "Wyrmscale""	"True"
"character_trait_levels_explanation_text_wh2_main_trait_def_name_of_power_ar_02_the_tempest_of_talons"	""	"True"
"character_trait_levels_colour_text_wh2_main_trait_def_name_of_power_ca_08_pathguard"	""	"True"
"character_trait_levels_onscreen_name_wh_dlc03_trait_name_dummy_the_one_eye"	""	"True"
"character_trait_levels_onscreen_name_wh2_dlc09_trait_patience"	"Shrewd Interrogator"	"True"
"character_trait_levels_onscreen_name_wh_dlc06_clan_angrund_ancestor_runesmith_1"	"Clan Angrund Ancestor"	"True"
"character_trait_levels_colour_text_wh2_main_trait_slaver"	""Flesh is just a commodity. Who cares whether it is living or dead\? Only the price matters - nothing more.""	"True"
"character_trait_levels_colour_text_wh_dlc06_clan_angrund_ancestor_thane_1"	""Centuries of shame in defeat shall be washed away â€˜neath my hammer; Clan Angrund will rise again!""	"True"
"character_trait_levels_explanation_text_wh2_main_trait_def_name_of_power_co_04_headreaper"	""	"True"
"character_trait_levels_removal_text_wh2_dlc09_trait_patience"	""	"True"
"character_trait_levels_onscreen_name_wh2_main_trait_reinforcing_vampires"	"Likes Vampires"	"True"
"character_trait_levels_explanation_text_wh2_main_trait_defeats_against_beastmen"	"Defeated by Beastmen"	"True"
"character_trait_levels_colour_text_wh_dlc07_trait_brt_lord_bad_kingslayer_1"	""And you could have it all; my empire of dirt.""	"True"
"character_trait_levels_explanation_text_wh2_main_trait_defeated_lord_mazdamundi"	"Defeated Lord Mazdamundi"	"True"
"character_trait_levels_explanation_text_wh2_main_trait_defeated_morathi"	"Defeated Morathi"	"True"
"character_trait_levels_removal_text_wh_main_trait_general_personality_vmp_black_arts_1"	""	"True"
"character_trait_levels_colour_text_wh_main_trait_general_personality_vmp_dark_acolyte_1"	"Some Vampires have an affinity for Necromantic magic beyond their peers."	"True"
"character_trait_levels_explanation_text_wh_dlc06_trait_name_dummy_ironhammer"	""	"True"
"character_trait_levels_onscreen_name_wh_dlc07_trait_brt_lord_bad_traitor_1"	"Traitor"	"True"
"character_trait_levels_onscreen_name_wh2_main_trait_def_favoured"	"Favoured"	"True"
"character_trait_levels_colour_text_wh2_main_trait_defeats_against_dwarfs"	"The bearded ones have sworn this one's death!"	"True"
"character_trait_levels_colour_text_wh2_main_trait_defeats_1"	"Suffering defeat once or twice is a mistake, but more than that is just careless."	"True"
"character_trait_levels_colour_text_wh2_main_trait_defeats_2"	"When defeat becomes a habit, shame comes afterwards as surely as night follows day."	"True"
"character_trait_levels_colour_text_wh2_main_trait_defeats_3"	"Even ignominy and shame cannot stand to be in the presence of such an utter, unmitigated failure."	"True"
"character_trait_levels_explanation_text_wh2_main_trait_wins_against_greenskins"	"Achieved victory over Greenskins multiple times"	"True"
"character_trait_levels_onscreen_name_wh2_dlc09_trait_settra_title_3"	"The King of Kings"	"True"
"character_trait_levels_removal_text_wh2_main_trait_skv_one_eye"	""	"True"
"character_trait_levels_onscreen_name_wh2_dlc09_trait_settra_title_2"	"High King of Nehekhara"	"True"
"character_trait_levels_onscreen_name_wh2_dlc09_trait_settra_title_1"	"Khemrikhara"	"True"
"character_trait_levels_removal_text_wh2_main_trait_reinforcing_beastmen"	""	"True"
"character_trait_levels_explanation_text_wh2_main_trait_sea_legs"	"Spent multiple turns at sea"	"True"
"character_trait_levels_explanation_text_wh_dlc07_trait_brt_lord_good_praying_1"	"Gained by spending multiple turns in a settlement with a chapel"	"True"
"character_trait_levels_removal_text_wh2_main_trait_agent_actions_against_beastmen"	""	"True"
"character_trait_levels_removal_text_wh2_main_trait_black_ark_building_wh2_main_horde_def_worship_2"	""	"True"
"character_trait_levels_removal_text_wh2_main_trait_black_ark_building_wh2_main_horde_def_worship_1"	""	"True"
"character_trait_levels_onscreen_name_wh2_main_trait_defeats_against_high_elves"	"Fears High Elves"	"True"
"character_trait_levels_onscreen_name_wh_dlc07_trait_brt_lord_bad_sacking_1"	"Looter"	"True"
"character_trait_levels_onscreen_name_wh_dlc07_trait_brt_lord_bad_sacking_3"	"Destroyer"	"True"
"character_trait_levels_onscreen_name_wh_dlc07_trait_brt_lord_bad_sacking_2"	"Butcher"	"True"
"character_trait_levels_explanation_text_wh_dlc07_trait_brt_lord_good_defeated_archaon_1"	"Gained by defeating Archaon the Everchosen in battle"	"True"
"character_trait_levels_colour_text_wh_dlc07_trait_brt_lord_bad_abducter_1"	""You, my sweet, will fetch a pretty price. Yes indeedâ€¦""	"True"
"character_trait_levels_colour_text_wh_dlc07_trait_brt_lord_bad_attacker_2"	"Strike hard and fast or not at all."	"True"
"character_trait_levels_colour_text_wh_dlc07_trait_brt_lord_bad_attacker_3"	"The gods do not look favourably on failure."	"True"
"character_trait_levels_colour_text_wh_dlc07_trait_brt_lord_bad_attacker_1"	"Which battlefield\?"	"True"
"character_trait_levels_removal_text_wh2_dlc09_trait_merciless"	""	"True"
"character_trait_levels_explanation_text_wh2_main_trait_reinforcing_skaven"	"Reinforced Skaven armies in battle multiple times"	"True"
"character_trait_levels_explanation_text_wh_main_trait_name_dummy_ironfist"	""	"True"
"character_trait_levels_removal_text_wh_main_trait_name_dummy_von_carstein"	""	"True"
"character_trait_levels_colour_text_wh_dlc07_trait_brt_lord_good_public_order_1"	""I am the law!""	"True"
"character_trait_levels_colour_text_wh2_dlc09_trait_settra_title_start"	""Kneel before the might of Settra the Imperishable...""	"True"
"character_trait_levels_removal_text_wh_main_trait_name_dummy_grudgebearer"	""	"True"
"character_trait_levels_explanation_text_wh2_main_trait_def_name_of_power_co_05_spiteheart"	""	"True"
"character_trait_levels_colour_text_wh2_main_trait_casualties_3"	""My victims will be drenched in their own blood, drowning in crimson gore. I swear it!""	"True"
"character_trait_levels_colour_text_wh2_main_trait_casualties_2"	"This one that revels in so much blood that even Khorne must take note."	"True"
"character_trait_levels_colour_text_wh2_main_trait_casualties_1"	"Call them 'the bloody'! The body-count attests to this."	"True"
"character_trait_levels_colour_text_wh2_main_trait_def_assassins_end"	"This one has slain a well-known assassin, raising his status somewhat in the process."	"True"
"character_trait_levels_explanation_text_wh2_main_trait_defeats_against_greenskins"	"Defeated by Greenskins"	"True"
"character_trait_levels_colour_text_wh2_main_trait_ruler_personality_queek_hates_dwarfs_greenskins"	""Ack, Queek smells hated Dwarf and Green-things here! Queek will slaughter all! Queek claims first-scavenge rights!""	"True"
"character_trait_levels_explanation_text_wh_dlc07_trait_brt_lord_bad_raider_1"	"Gained by using raiding stance"	"True"
"character_trait_levels_explanation_text_wh2_main_trait_defeated_balthasar_gelt"	"Defeated Balthasar Gelt"	"True"
"character_trait_levels_colour_text_wh2_main_trait_defeats_against_humans"	"There is a reason the Dark Gods are hell-bent on the destruction of manâ€¦"	"True"
"character_trait_levels_onscreen_name_wh_dlc07_trait_brt_lord_bad_villain_1"	"Villain"	"True"
"character_trait_levels_removal_text_wh2_main_trait_agent_target_success_1"	""	"True"
"character_trait_levels_explanation_text_wh2_main_trait_brutally_honest"	""	"True"
"character_trait_levels_removal_text_wh2_main_trait_agent_target_success_2"	""	"True"
"character_trait_levels_removal_text_wh2_main_trait_agent_target_success_3"	""	"True"
"character_trait_levels_removal_text_wh2_main_trait_general_status_all_cursed"	""	"True"
"character_trait_levels_colour_text_wh2_main_trait_reinforcing_chaos"	"Beseech the Dark Gods."	"True"
"character_trait_levels_colour_text_wh2_main_trait_def_name_of_power_ar_04_barbstorm"	""	"True"
"character_trait_levels_onscreen_name_wh2_main_trait_attacking_defeat_1"	"Indecisive Attacker"	"True"
"character_trait_levels_onscreen_name_wh2_main_trait_attacking_defeat_2"	"Poor Attacker"	"True"
"character_trait_levels_onscreen_name_wh2_main_trait_attacking_defeat_3"	"Incompetent Attacker"	"True"
"character_trait_levels_onscreen_name_wh2_main_trait_agent_actions_against_skaven"	"Hates Skaven"	"True"
"character_trait_levels_colour_text_wh2_main_trait_agent_action_damage_walls"	"\{\{tr:agent_action_damage_walls_description}}"	"True"
"character_trait_levels_explanation_text_wh2_main_trait_ruler_personality_tiranoc_chariots"	""	"True"
"character_trait_levels_onscreen_name_wh2_main_trait_general_status_all_cursed"	"Accursed"	"True"
"character_trait_levels_explanation_text_wh_dlc07_trait_brt_lord_good_far_from_capital_1"	"Gained by fighting battles far by the capital"	"True"
"character_trait_levels_onscreen_name_wh2_main_trait_agent_actions_against_chaos"	"Hates Chaos"	"True"
"character_trait_levels_explanation_text_wh2_main_trait_defeated_archaon_the_everchosen"	"Defeated Archaon the Everchosen"	"True"
"character_trait_levels_colour_text_wh2_main_trait_agent_actions_against_vampires"	""The von Carsteins have crossed us - bring wrath upon their cursed bloodline!""	"True"
"character_trait_levels_colour_text_wh2_main_trait_def_name_of_power_ar_12_grimgaze"	""	"True"
"character_trait_levels_explanation_text_wh2_main_trait_def_name_of_power_co_12_hydrablood"	""	"True"
"character_trait_levels_removal_text_wh_dlc07_trait_brt_lord_good_greenskins_1"	""	"True"
"character_trait_levels_onscreen_name_wh_dlc04_trait_name_dummy_ghorst"	""	"True"
"character_trait_levels_onscreen_name_wh2_dlc09_trait_defeated_khalida"	"Khalida Never-Living"	"True"
"character_trait_levels_onscreen_name_wh2_main_trait_defeated_lord_strolk"	"Plaguelash"	"True"
"character_trait_levels_explanation_text_wh2_main_trait_agent_actions_against_greenskins"	"Carried out successful [[img:icon_hero]][[/img]]Hero actions against Greenskins"	"True"
"character_trait_levels_removal_text_wh2_main_trait_black_ark_building_wh2_main_horde_def_slavery_2"	""	"True"
"character_trait_levels_removal_text_wh_dlc04_trait_name_dummy_ghorst"	""	"True"
"character_trait_levels_removal_text_wh2_main_trait_black_ark_building_wh2_main_horde_def_slavery_3"	""	"True"
"character_trait_levels_removal_text_wh2_main_trait_black_ark_building_wh2_main_horde_def_slavery_1"	""	"True"
"character_trait_levels_explanation_text_wh_dlc03_trait_name_dummy_todbringer"	""	"True"
"character_trait_levels_removal_text_wh_dlc05_trait_name_dummy_morghur_1"	""	"True"
"character_trait_levels_explanation_text_wh_dlc07_trait_brt_lord_good_defeated_grimgor_1"	"Gained by defeating Grimgor Ironhide in battle"	"True"
"character_trait_levels_explanation_text_wh2_main_trait_def_name_of_power_co_01_blackstone"	""	"True"
"character_trait_levels_removal_text_wh2_dlc09_trait_defeated_khalida"	""	"True"
"character_trait_levels_explanation_text_wh2_main_trait_defeated_prince_sigvald"	"Defeated Prince Sigvald the Magnificent"	"True"
"character_trait_levels_colour_text_wh_dlc07_trait_brt_lord_good_executing_1"	"Sickness must be purged, and purged it shall be!"	"True"
"character_trait_levels_removal_text_wh_dlc07_trait_brt_lord_good_lone_wolf_2"	""	"True"
"character_trait_levels_removal_text_wh_dlc07_trait_brt_lord_good_lone_wolf_1"	""	"True"
"character_trait_levels_removal_text_wh2_main_trait_agent_actions_against_skaven"	""	"True"
"character_trait_levels_removal_text_wh2_main_trait_defending_victory_1"	""	"True"
"character_trait_levels_removal_text_wh2_main_trait_defending_victory_2"	""	"True"
"character_trait_levels_removal_text_wh2_main_trait_defending_victory_3"	""	"True"
"character_trait_levels_colour_text_wh2_main_trait_builder_3"	"To plan buildings from the ground upâ€¦ that is a strange concept in these parts."	"True"
"character_trait_levels_colour_text_wh2_main_trait_builder_2"	""Ah, lad, an engineer knows the sweet spot in any building!""	"True"
"character_trait_levels_onscreen_name_wh_dlc07_trait_brt_lord_good_lone_wolf_1"	"Independent"	"True"
"character_trait_levels_colour_text_wh2_main_trait_builder_1"	"Build upon the bones and remnants of your fallen enemies!"	"True"
"character_trait_levels_onscreen_name_wh_dlc07_trait_brt_lord_good_lone_wolf_2"	"Lone Wolf"	"True"
"character_trait_levels_explanation_text_wh2_main_trait_def_name_of_power_ca_05_leviathanrage"	""	"True"
"character_trait_levels_removal_text_wh2_main_trait_defeats_against_dwarfs"	""	"True"
"character_trait_levels_removal_text_wh2_main_trait_def_name_of_power_co_06_soulblaze"	""	"True"
"character_trait_levels_removal_text_wh2_main_trait_defeated_lord_strolk"	""	"True"
"character_trait_levels_onscreen_name_wh2_main_trait_def_name_of_power_co_06_soulblaze"	"Name of Power: "Soulblaze""	"True"
"character_trait_levels_onscreen_name_wh_dlc05_trait_name_dummy_morghur_1"	""	"True"
"character_trait_levels_explanation_text_wh2_main_trait_def_name_of_power_ar_05_beastbinder"	""	"True"
"character_trait_levels_colour_text_wh2_main_trait_def_name_of_power_co_02_wyrmscale"	""	"True"
"character_trait_levels_colour_text_wh2_main_trait_wins_against_wood_elves"	"The preening, superior Wood Elves rarely stand a chance against this warrior of note."	"True"
"character_trait_levels_explanation_text_wh_dlc07_trait_brt_lord_bad_defeat_1"	"Gained by losing more than 50% of battles"	"True"
"character_trait_levels_explanation_text_wh_dlc07_trait_brt_lord_bad_defeat_2"	"Gained by losing more than 50% of battles"	"True"
"character_trait_levels_explanation_text_wh2_main_trait_skv_flayed_tail"	"Awarded through a Loyalty dilemma."	"True"
"character_trait_levels_colour_text_wh_dlc07_trait_brt_lord_bad_defender_1"	"Which wall to place the soldiers on\? All of them maybe\?"	"True"
"character_trait_levels_colour_text_wh_dlc07_trait_brt_lord_bad_defender_2"	"A poor defence means those walls will count for nought."	"True"
"character_trait_levels_colour_text_wh_dlc07_trait_brt_lord_bad_defender_3"	"Known as "The fool on the wall" on the other side."	"True"
"character_trait_levels_explanation_text_wh2_main_trait_defeated_morghur_the_shadowgave"	"Defeated Morghur the Shadowgave"	"True"
"character_trait_levels_colour_text_wh2_main_trait_agent_actions_against_beastmen"	"The disgusting, insidious Children of Chaos must be wiped from the face of the world."	"True"
"character_trait_levels_explanation_text_wh2_main_trait_defeated_tyrion"	"Defeated Tyrion"	"True"
"character_trait_levels_onscreen_name_wh2_main_trait_agent_action_wound"	"\{\{tr:agent_action_wound_name}}"	"True"
"character_trait_levels_explanation_text_wh2_main_trait_wounded"	"Wounded during multiple assassination attempts"	"True"
"character_trait_levels_removal_text_wh2_main_trait_def_name_of_power_ca_08_pathguard"	""	"True"
"character_trait_levels_explanation_text_wh2_main_trait_def_name_of_power_ar_09_granitestance"	""	"True"
"character_trait_levels_removal_text_wh_dlc07_trait_brt_lord_good_reinforcing_1"	""	"True"
"character_trait_levels_onscreen_name_wh2_main_trait_def_name_of_power_ca_08_pathguard"	"Name of Power: "Pathguard""	"True"
"character_trait_levels_colour_text_wh2_dlc09_trait_merciless"	"The servants of the Great Horned Rat are entirely blunt instruments â€“ pity, remorse, forgiveness are entirely alien to their nature."	"True"
"character_trait_levels_colour_text_wh_main_trait_name_dummy_von_carstein"	"."	"True"
"character_trait_levels_colour_text_wh2_dlc09_trait_patience"	"Skaven are not known to be patient â€“ intolerant, implacable, unsparing and ruthless perhaps, but not patient; this one might just be the exception, but then he is playing a much longer game..."	"True"
"character_trait_levels_onscreen_name_wh2_main_trait_reinforcing_beastmen"	"Likes Beastmen"	"True"
"character_trait_levels_removal_text_wh2_main_trait_skv_badly_mutated"	""	"True"
"character_trait_levels_removal_text_wh2_main_trait_agent_action_hinder_replenishment"	""	"True"
"character_trait_levels_explanation_text_wh2_main_trait_defeats_against_vampires"	"Defeated by Vampire Counts"	"True"
"character_trait_levels_colour_text_wh2_main_trait_fighter_3"	"Nothing can cow this one."	"True"
"character_trait_levels_colour_text_wh2_main_trait_fighter_2"	"Insane courage! Clearly rolled a double-1â€¦"	"True"
"character_trait_levels_colour_text_wh2_main_trait_fighter_1"	"This one is no craven!"	"True"
"character_trait_levels_colour_text_wh_main_trait_name_dummy_grudgebearer"	"."	"True"
"character_trait_levels_onscreen_name_wh2_main_trait_skv_badly_mutated"	"Badly Mutated"	"True"
"character_trait_levels_onscreen_name_wh2_main_trait_agent_action_hinder_replenishment"	"\{\{tr:agent_action_hinder_replenishment_name}}"	"True"
"character_trait_levels_removal_text_wh_dlc04_trait_name_dummy_the_grim"	""	"True"
"character_trait_levels_explanation_text_wh2_main_trait_skv_boom_master"	"Awarded through a Loyalty dilemma."	"True"
"character_trait_levels_explanation_text_wh_dlc07_trait_brt_lord_good_defeated_manfred_1"	"Gained by defeating Mannfred von Carstein in battle"	"True"
"character_trait_levels_explanation_text_wh2_main_trait_defeated_teclis"	"Defeated Teclis"	"True"
"character_trait_levels_removal_text_wh2_main_trait_defeats_against_humans"	""	"True"
"character_trait_levels_colour_text_wh2_main_trait_agent_target_success_1"	""Oh dearâ€¦""	"True"
"character_trait_levels_colour_text_wh2_main_trait_agent_target_success_2"	"Some would call it incompetence, but it's just unfortunate."	"True"
"character_trait_levels_colour_text_wh2_main_trait_agent_target_success_3"	"Don't listen to the whispers that call this one cursedâ€¦ it may be true, but still, do not listen."	"True"
"character_trait_levels_removal_text_wh2_main_trait_wins_against_skaven"	""	"True"
"character_trait_levels_removal_text_wh2_main_trait_defeated_belegar_ironhammer"	""	"True"
"character_trait_levels_explanation_text_wh2_main_trait_reinforcing_lizardmen"	"Reinforced Lizardmen armies in battle multiple times"	"True"
"character_trait_levels_colour_text_wh2_dlc09_trait_benevolence"	"What\? Benign\? Compassionate\? Empathetic, even\? A Skaven\? Can it be true\? Surely this is a ruse\?"	"True"
"character_trait_levels_removal_text_wh2_main_trait_reinforcing_vampires"	""	"True"
"character_trait_levels_onscreen_name_wh_dlc07_trait_brt_lord_bad_scared_of_greenskins_1"	"Primal Fear"	"True"
"character_trait_levels_colour_text_wh2_main_trait_corrupted_chaos"	"Maybe realisation of Chaos' true nature or simply too much fungus brew\? Either way - this one is insane!"	"True"
"character_trait_levels_removal_text_wh2_main_trait_agent_actions_against_vampires"	""	"True"
"character_trait_levels_onscreen_name_wh2_main_trait_defending_defeat_2"	"Poor Defender"	"True"
"character_trait_levels_onscreen_name_wh2_main_trait_defending_defeat_3"	"Incompetent Defender"	"True"
"character_trait_levels_onscreen_name_wh2_main_trait_defending_defeat_1"	"Hesitant Defender"	"True"
"character_trait_levels_onscreen_name_wh2_main_trait_stance_forced_march"	"Taskmaster"	"True"
"character_trait_levels_explanation_text_wh2_main_trait_def_name_of_power_co_03_poisonblade"	""	"True"
"character_trait_levels_onscreen_name_wh2_main_trait_defeats_against_dark_elves"	"Fears Dark Elves"	"True"
"character_trait_levels_explanation_text_wh2_main_trait_def_name_of_power_ar_03_shadowdart"	""	"True"
"character_trait_levels_onscreen_name_wh_dlc07_trait_brt_lord_bad_sieging_1"	"Incompetent Besieger"	"True"
"character_trait_levels_onscreen_name_wh_dlc07_trait_brt_lord_bad_sieging_3"	"Terrified of Walls"	"True"
"character_trait_levels_onscreen_name_wh_dlc07_trait_brt_lord_bad_sieging_2"	"Confounded by Siegecraft"	"True"
"character_trait_levels_explanation_text_wh_dlc07_trait_brt_lord_good_chaos_1"	"Gained by winning battles against Chaos factions"	"True"
"character_trait_levels_removal_text_wh2_main_trait_def_favoured"	""	"True"
"character_trait_levels_explanation_text_wh2_main_trait_defeated_kholek_suneater"	"Defeated Kholek Suneater"	"True"
"character_trait_levels_colour_text_wh2_main_trait_def_name_of_power_ca_04_the_black_conqueror"	""	"True"
"character_trait_levels_explanation_text_wh_dlc07_trait_brt_lord_good_victory_2"	"Gained by winning more than 90% of battles"	"True"
"character_trait_levels_explanation_text_wh_dlc07_trait_brt_lord_good_victory_3"	"Gained by winning more than 90% of battles"	"True"
"character_trait_levels_explanation_text_wh_dlc07_trait_brt_lord_good_victory_1"	"Gained by winning more than 90% of battles"	"True"
"character_trait_levels_removal_text_wh2_main_trait_def_name_of_power_co_09_the_hand_of_wrath"	""	"True"
"character_trait_levels_colour_text_wh2_main_trait_sacking_3"	"Find me their trinkets and things, I will take them all."	"True"
"character_trait_levels_colour_text_wh2_main_trait_sacking_2"	"Slicing fingers to get at rings, or heads to free 